9,1,50,0,33,"setup@22-55@/home/quique/Documentos/RHA/SW/src/main.cpp","/home/quique/Documentos/RHA/SW/src/main.cpp","setup",22,55
19,2,276,0,23,"loop@63-86@/home/quique/Documentos/RHA/SW/src/main.cpp","/home/quique/Documentos/RHA/SW/src/main.cpp","loop",63,86
5,2,38,0,4,"RHATypes::Regulator::Regulator@32-36@/home/quique/Documentos/RHA/SW/lib/rha_types/pid_regulator.h","/home/quique/Documentos/RHA/SW/lib/rha_types/pid_regulator.h","RHATypes::Regulator::Regulator",32,36
4,2,36,0,3,"RHATypes::Regulator::resetRegulator@42-45@/home/quique/Documentos/RHA/SW/lib/rha_types/pid_regulator.h","/home/quique/Documentos/RHA/SW/lib/rha_types/pid_regulator.h","RHATypes::Regulator::resetRegulator",42,45
3,1,29,3,2,"RHATypes::Regulator::setKRegulator@54-56@/home/quique/Documentos/RHA/SW/lib/rha_types/pid_regulator.h","/home/quique/Documentos/RHA/SW/lib/rha_types/pid_regulator.h","RHATypes::Regulator::setKRegulator",54,56
8,3,78,3,8,"RHATypes::Regulator::regulator@66-74@/home/quique/Documentos/RHA/SW/lib/rha_types/pid_regulator.h","/home/quique/Documentos/RHA/SW/lib/rha_types/pid_regulator.h","RHATypes::Regulator::regulator",66,74
1,1,8,0,0,"RHATypes::Regulator::getKp@76-76@/home/quique/Documentos/RHA/SW/lib/rha_types/pid_regulator.h","/home/quique/Documentos/RHA/SW/lib/rha_types/pid_regulator.h","RHATypes::Regulator::getKp",76,76
1,1,8,0,0,"RHATypes::Regulator::getKi@77-77@/home/quique/Documentos/RHA/SW/lib/rha_types/pid_regulator.h","/home/quique/Documentos/RHA/SW/lib/rha_types/pid_regulator.h","RHATypes::Regulator::getKi",77,77
1,1,8,0,0,"RHATypes::Regulator::getKd@78-78@/home/quique/Documentos/RHA/SW/lib/rha_types/pid_regulator.h","/home/quique/Documentos/RHA/SW/lib/rha_types/pid_regulator.h","RHATypes::Regulator::getKd",78,78
3,1,13,0,2,"RHATypes::FuzzyRegulatorNode::FuzzyRegulatorNode@28-30@/home/quique/Documentos/RHA/SW/lib/rha_types/fuzzy_regulator.h","/home/quique/Documentos/RHA/SW/lib/rha_types/fuzzy_regulator.h","RHATypes::FuzzyRegulatorNode::FuzzyRegulatorNode",28,30
4,1,15,0,3,"RHATypes::FuzzyRegulatorNode::resetRegulator@36-39@/home/quique/Documentos/RHA/SW/lib/rha_types/fuzzy_regulator.h","/home/quique/Documentos/RHA/SW/lib/rha_types/fuzzy_regulator.h","RHATypes::FuzzyRegulatorNode::resetRegulator",36,39
4,1,35,4,3,"RHATypes::FuzzyRegulatorNode::setRegulator@49-52@/home/quique/Documentos/RHA/SW/lib/rha_types/fuzzy_regulator.h","/home/quique/Documentos/RHA/SW/lib/rha_types/fuzzy_regulator.h","RHATypes::FuzzyRegulatorNode::setRegulator",49,52
3,1,29,3,2,"RHATypes::FuzzyRegulatorNode::regulator@54-56@/home/quique/Documentos/RHA/SW/lib/rha_types/fuzzy_regulator.h","/home/quique/Documentos/RHA/SW/lib/rha_types/fuzzy_regulator.h","RHATypes::FuzzyRegulatorNode::regulator",54,56
1,1,8,0,0,"RHATypes::FuzzyRegulatorNode::getAplicationPoint@58-58@/home/quique/Documentos/RHA/SW/lib/rha_types/fuzzy_regulator.h","/home/quique/Documentos/RHA/SW/lib/rha_types/fuzzy_regulator.h","RHATypes::FuzzyRegulatorNode::getAplicationPoint",58,58
12,1,165,0,12,"RHATypes::FuzzyRegulator::FuzzyRegulator@65-77@/home/quique/Documentos/RHA/SW/lib/rha_types/fuzzy_regulator.h","/home/quique/Documentos/RHA/SW/lib/rha_types/fuzzy_regulator.h","RHATypes::FuzzyRegulator::FuzzyRegulator",65,77
15,4,144,4,17,"RHATypes::FuzzyRegulator::regulator@88-105@/home/quique/Documentos/RHA/SW/lib/rha_types/fuzzy_regulator.h","/home/quique/Documentos/RHA/SW/lib/rha_types/fuzzy_regulator.h","RHATypes::FuzzyRegulator::regulator",88,105
1,1,36,4,0,"RHATypes::SpeedGoal::SpeedGoal@33-33@/home/quique/Documentos/RHA/SW/lib/rha_types/rha_types.h","/home/quique/Documentos/RHA/SW/lib/rha_types/rha_types.h","RHATypes::SpeedGoal::SpeedGoal",33,33
3,1,11,1,2,"RHATypes::Timer::setTimer@48-50@/home/quique/Documentos/RHA/SW/lib/rha_types/rha_types.h","/home/quique/Documentos/RHA/SW/lib/rha_types/rha_types.h","RHATypes::Timer::setTimer",48,50
4,1,16,0,3,"RHATypes::Timer::activateTimer@56-59@/home/quique/Documentos/RHA/SW/lib/rha_types/rha_types.h","/home/quique/Documentos/RHA/SW/lib/rha_types/rha_types.h","RHATypes::Timer::activateTimer",56,59
6,2,37,0,5,"RHATypes::Timer::checkWait@65-70@/home/quique/Documentos/RHA/SW/lib/rha_types/rha_types.h","/home/quique/Documentos/RHA/SW/lib/rha_types/rha_types.h","RHATypes::Timer::checkWait",65,70
6,2,37,0,5,"RHATypes::Timer::checkContinue@77-82@/home/quique/Documentos/RHA/SW/lib/rha_types/rha_types.h","/home/quique/Documentos/RHA/SW/lib/rha_types/rha_types.h","RHATypes::Timer::checkContinue",77,82
1,1,8,0,0,"RHATypes::Timer::getInitTime@89-89@/home/quique/Documentos/RHA/SW/lib/rha_types/rha_types.h","/home/quique/Documentos/RHA/SW/lib/rha_types/rha_types.h","RHATypes::Timer::getInitTime",89,89
4,1,16,0,3,"RHATypes::TimerMicroseconds::activateTimer@102-105@/home/quique/Documentos/RHA/SW/lib/rha_types/rha_types.h","/home/quique/Documentos/RHA/SW/lib/rha_types/rha_types.h","RHATypes::TimerMicroseconds::activateTimer",102,105
6,2,37,0,5,"RHATypes::TimerMicroseconds::checkWait@111-116@/home/quique/Documentos/RHA/SW/lib/rha_types/rha_types.h","/home/quique/Documentos/RHA/SW/lib/rha_types/rha_types.h","RHATypes::TimerMicroseconds::checkWait",111,116
6,2,37,0,5,"RHATypes::TimerMicroseconds::checkContinue@122-127@/home/quique/Documentos/RHA/SW/lib/rha_types/rha_types.h","/home/quique/Documentos/RHA/SW/lib/rha_types/rha_types.h","RHATypes::TimerMicroseconds::checkContinue",122,127
3,1,16,1,2,"JointHandler::JointHandler@23-25@/home/quique/Documentos/RHA/SW/lib/joint_handler/joint_handler.cpp","/home/quique/Documentos/RHA/SW/lib/joint_handler/joint_handler.cpp","JointHandler::JointHandler",23,25
5,1,27,1,4,"JointHandler::setTimer@32-36@/home/quique/Documentos/RHA/SW/lib/joint_handler/joint_handler.cpp","/home/quique/Documentos/RHA/SW/lib/joint_handler/joint_handler.cpp","JointHandler::setTimer",32,36
18,1,129,0,23,"JointHandler::initJoints@42-65@/home/quique/Documentos/RHA/SW/lib/joint_handler/joint_handler.cpp","/home/quique/Documentos/RHA/SW/lib/joint_handler/joint_handler.cpp","JointHandler::initJoints",42,65
12,2,55,0,18,"JointHandler::controlLoop@70-88@/home/quique/Documentos/RHA/SW/lib/joint_handler/joint_handler.cpp","/home/quique/Documentos/RHA/SW/lib/joint_handler/joint_handler.cpp","JointHandler::controlLoop",70,88
12,2,97,0,11,"JointHandler::updateJointInfo@95-106@/home/quique/Documentos/RHA/SW/lib/joint_handler/joint_handler.cpp","/home/quique/Documentos/RHA/SW/lib/joint_handler/joint_handler.cpp","JointHandler::updateJointInfo",95,106
7,2,50,0,6,"JointHandler::updateJointErrorTorque@112-118@/home/quique/Documentos/RHA/SW/lib/joint_handler/joint_handler.cpp","/home/quique/Documentos/RHA/SW/lib/joint_handler/joint_handler.cpp","JointHandler::updateJointErrorTorque",112,118
15,3,106,0,14,"JointHandler::sendJointTorques@124-138@/home/quique/Documentos/RHA/SW/lib/joint_handler/joint_handler.cpp","/home/quique/Documentos/RHA/SW/lib/joint_handler/joint_handler.cpp","JointHandler::sendJointTorques",124,138
6,3,48,1,5,"JointHandler::setSpeedGoal@145-150@/home/quique/Documentos/RHA/SW/lib/joint_handler/joint_handler.cpp","/home/quique/Documentos/RHA/SW/lib/joint_handler/joint_handler.cpp","JointHandler::setSpeedGoal",145,150
11,2,89,1,10,"JointHandler::setReturnPacketOption@152-162@/home/quique/Documentos/RHA/SW/lib/joint_handler/joint_handler.cpp","/home/quique/Documentos/RHA/SW/lib/joint_handler/joint_handler.cpp","JointHandler::setReturnPacketOption",152,162
25,3,194,0,28,"JointHandler::sendSetWheelModeAll@168-196@/home/quique/Documentos/RHA/SW/lib/joint_handler/joint_handler.cpp","/home/quique/Documentos/RHA/SW/lib/joint_handler/joint_handler.cpp","JointHandler::sendSetWheelModeAll",168,196
18,2,126,0,26,"JointHandler::sendExitWheelModeAll@202-228@/home/quique/Documentos/RHA/SW/lib/joint_handler/joint_handler.cpp","/home/quique/Documentos/RHA/SW/lib/joint_handler/joint_handler.cpp","JointHandler::sendExitWheelModeAll",202,228
11,2,89,1,10,"JointHandler::sendSetTorqueLimitAll@236-246@/home/quique/Documentos/RHA/SW/lib/joint_handler/joint_handler.cpp","/home/quique/Documentos/RHA/SW/lib/joint_handler/joint_handler.cpp","JointHandler::sendSetTorqueLimitAll",236,246
17,3,153,2,16,"JointHandler::sendSetWheelSpeedAll@255-271@/home/quique/Documentos/RHA/SW/lib/joint_handler/joint_handler.cpp","/home/quique/Documentos/RHA/SW/lib/joint_handler/joint_handler.cpp","JointHandler::sendSetWheelSpeedAll",255,271
13,3,97,0,12,"JointHandler::checkConectionAll@279-291@/home/quique/Documentos/RHA/SW/lib/joint_handler/joint_handler.cpp","/home/quique/Documentos/RHA/SW/lib/joint_handler/joint_handler.cpp","JointHandler::checkConectionAll",279,291
8,2,74,3,7,"JointHandler::addToSyncPacket@306-313@/home/quique/Documentos/RHA/SW/lib/joint_handler/joint_handler.cpp","/home/quique/Documentos/RHA/SW/lib/joint_handler/joint_handler.cpp","JointHandler::addToSyncPacket",306,313
17,2,173,5,19,"JointHandler::warpSyncPacket@326-345@/home/quique/Documentos/RHA/SW/lib/joint_handler/joint_handler.cpp","/home/quique/Documentos/RHA/SW/lib/joint_handler/joint_handler.cpp","JointHandler::warpSyncPacket",326,345
15,2,144,3,17,"JointHandler::warpSinglePacket@355-372@/home/quique/Documentos/RHA/SW/lib/joint_handler/joint_handler.cpp","/home/quique/Documentos/RHA/SW/lib/joint_handler/joint_handler.cpp","JointHandler::warpSinglePacket",355,372
71,20,454,1,97,"JointHandler::sendPacket@380-477@/home/quique/Documentos/RHA/SW/lib/joint_handler/joint_handler.cpp","/home/quique/Documentos/RHA/SW/lib/joint_handler/joint_handler.cpp","JointHandler::sendPacket",380,477
5,1,27,3,4,"JointHandler::JointHandler@491-495@/home/quique/Documentos/RHA/SW/lib/joint_handler/joint_handler.cpp","/home/quique/Documentos/RHA/SW/lib/joint_handler/joint_handler.cpp","JointHandler::JointHandler",491,495
5,1,21,1,4,"JointHandler::JointHandler@502-506@/home/quique/Documentos/RHA/SW/lib/joint_handler/joint_handler.cpp","/home/quique/Documentos/RHA/SW/lib/joint_handler/joint_handler.cpp","JointHandler::JointHandler",502,506
7,1,40,4,6,"JointHandler::initSerial@517-523@/home/quique/Documentos/RHA/SW/lib/joint_handler/joint_handler.cpp","/home/quique/Documentos/RHA/SW/lib/joint_handler/joint_handler.cpp","JointHandler::initSerial",517,523
18,5,120,1,17,"JointHandler::begin@530-547@/home/quique/Documentos/RHA/SW/lib/joint_handler/joint_handler.cpp","/home/quique/Documentos/RHA/SW/lib/joint_handler/joint_handler.cpp","JointHandler::begin",530,547
10,4,65,1,9,"JointHandler::end@549-558@/home/quique/Documentos/RHA/SW/lib/joint_handler/joint_handler.cpp","/home/quique/Documentos/RHA/SW/lib/joint_handler/joint_handler.cpp","JointHandler::end",549,558
3,1,15,1,2,"JointHandler::setTxMode@560-562@/home/quique/Documentos/RHA/SW/lib/joint_handler/joint_handler.cpp","/home/quique/Documentos/RHA/SW/lib/joint_handler/joint_handler.cpp","JointHandler::setTxMode",560,562
3,1,15,1,2,"JointHandler::setRxMode@564-566@/home/quique/Documentos/RHA/SW/lib/joint_handler/joint_handler.cpp","/home/quique/Documentos/RHA/SW/lib/joint_handler/joint_handler.cpp","JointHandler::setRxMode",564,566
1,1,5,0,0,"JointHandler::JointHandler@84-84@/home/quique/Documentos/RHA/SW/lib/joint_handler/joint_handler.h","/home/quique/Documentos/RHA/SW/lib/joint_handler/joint_handler.h","JointHandler::JointHandler",84,84
7,1,43,0,6,"RobotRHA::initJointHandler@7-13@/home/quique/Documentos/RHA/SW/lib/robot_rha/robot_rha.cpp","/home/quique/Documentos/RHA/SW/lib/robot_rha/robot_rha.cpp","RobotRHA::initJointHandler",7,13
6,1,30,0,5,"RobotRHA::initChuckHandler@19-24@/home/quique/Documentos/RHA/SW/lib/robot_rha/robot_rha.cpp","/home/quique/Documentos/RHA/SW/lib/robot_rha/robot_rha.cpp","RobotRHA::initChuckHandler",19,24
2,1,7,0,1,"RobotRHA::handleRobot@26-27@/home/quique/Documentos/RHA/SW/lib/robot_rha/robot_rha.cpp","/home/quique/Documentos/RHA/SW/lib/robot_rha/robot_rha.cpp","RobotRHA::handleRobot",26,27
9,1,62,3,8,"RobotRHA::setCartesianSpeedGoal@36-44@/home/quique/Documentos/RHA/SW/lib/robot_rha/robot_rha.cpp","/home/quique/Documentos/RHA/SW/lib/robot_rha/robot_rha.cpp","RobotRHA::setCartesianSpeedGoal",36,44
6,2,54,2,5,"RobotRHA::setSpeedToServos@52-57@/home/quique/Documentos/RHA/SW/lib/robot_rha/robot_rha.cpp","/home/quique/Documentos/RHA/SW/lib/robot_rha/robot_rha.cpp","RobotRHA::setSpeedToServos",52,57
15,2,103,0,17,"RobotRHA::handleWithChuck@63-80@/home/quique/Documentos/RHA/SW/lib/robot_rha/robot_rha.cpp","/home/quique/Documentos/RHA/SW/lib/robot_rha/robot_rha.cpp","RobotRHA::handleWithChuck",63,80
1,1,5,0,0,"JointRHA::JointRHA@38-38@/home/quique/Documentos/RHA/SW/lib/joint_rha/joint_rha.h","/home/quique/Documentos/RHA/SW/lib/joint_rha/joint_rha.h","JointRHA::JointRHA",38,38
1,1,8,0,0,"JointRHA::getPosition@49-49@/home/quique/Documentos/RHA/SW/lib/joint_rha/joint_rha.h","/home/quique/Documentos/RHA/SW/lib/joint_rha/joint_rha.h","JointRHA::getPosition",49,49
5,1,30,3,5,"JointRHA::JointRHA@19-24@/home/quique/Documentos/RHA/SW/lib/joint_rha/joint_rha.cpp","/home/quique/Documentos/RHA/SW/lib/joint_rha/joint_rha.cpp","JointRHA::JointRHA",19,24
2,1,7,0,1,"JointRHA::~JointRHA@28-29@/home/quique/Documentos/RHA/SW/lib/joint_rha/joint_rha.cpp","/home/quique/Documentos/RHA/SW/lib/joint_rha/joint_rha.cpp","JointRHA::~JointRHA",28,29
9,2,59,3,9,"JointRHA::init@36-45@/home/quique/Documentos/RHA/SW/lib/joint_rha/joint_rha.cpp","/home/quique/Documentos/RHA/SW/lib/joint_rha/joint_rha.cpp","JointRHA::init",36,45
6,2,37,0,5,"JointRHA::updatePosition@52-57@/home/quique/Documentos/RHA/SW/lib/joint_rha/joint_rha.cpp","/home/quique/Documentos/RHA/SW/lib/joint_rha/joint_rha.cpp","JointRHA::updatePosition",52,57
3,1,13,1,2,"JointRHA::setPotRelation@64-66@/home/quique/Documentos/RHA/SW/lib/joint_rha/joint_rha.cpp","/home/quique/Documentos/RHA/SW/lib/joint_rha/joint_rha.cpp","JointRHA::setPotRelation",64,66
4,1,28,2,3,"JointRHA::updateInfo@75-78@/home/quique/Documentos/RHA/SW/lib/joint_rha/joint_rha.cpp","/home/quique/Documentos/RHA/SW/lib/joint_rha/joint_rha.cpp","JointRHA::updateInfo",75,78
2,1,29,0,1,"ServoRHA::ServoRHA@147-148@/home/quique/Documentos/RHA/SW/lib/servo_rha/servo_rha.h","/home/quique/Documentos/RHA/SW/lib/servo_rha/servo_rha.h","ServoRHA::ServoRHA",147,148
1,1,8,0,0,"ServoRHA::getID@179-179@/home/quique/Documentos/RHA/SW/lib/servo_rha/servo_rha.h","/home/quique/Documentos/RHA/SW/lib/servo_rha/servo_rha.h","ServoRHA::getID",179,179
1,1,8,0,0,"ServoRHA::getSpeed@180-180@/home/quique/Documentos/RHA/SW/lib/servo_rha/servo_rha.h","/home/quique/Documentos/RHA/SW/lib/servo_rha/servo_rha.h","ServoRHA::getSpeed",180,180
1,1,8,0,0,"ServoRHA::getSpeedDir@181-181@/home/quique/Documentos/RHA/SW/lib/servo_rha/servo_rha.h","/home/quique/Documentos/RHA/SW/lib/servo_rha/servo_rha.h","ServoRHA::getSpeedDir",181,181
1,1,8,0,0,"ServoRHA::getPosition@182-182@/home/quique/Documentos/RHA/SW/lib/servo_rha/servo_rha.h","/home/quique/Documentos/RHA/SW/lib/servo_rha/servo_rha.h","ServoRHA::getPosition",182,182
1,1,8,0,0,"ServoRHA::getLoad@183-183@/home/quique/Documentos/RHA/SW/lib/servo_rha/servo_rha.h","/home/quique/Documentos/RHA/SW/lib/servo_rha/servo_rha.h","ServoRHA::getLoad",183,183
1,1,8,0,0,"ServoRHA::getLoadDir@184-184@/home/quique/Documentos/RHA/SW/lib/servo_rha/servo_rha.h","/home/quique/Documentos/RHA/SW/lib/servo_rha/servo_rha.h","ServoRHA::getLoadDir",184,184
1,1,8,0,0,"ServoRHA::getCommError@185-185@/home/quique/Documentos/RHA/SW/lib/servo_rha/servo_rha.h","/home/quique/Documentos/RHA/SW/lib/servo_rha/servo_rha.h","ServoRHA::getCommError",185,185
1,1,8,0,0,"ServoRHA::getVoltage@186-186@/home/quique/Documentos/RHA/SW/lib/servo_rha/servo_rha.h","/home/quique/Documentos/RHA/SW/lib/servo_rha/servo_rha.h","ServoRHA::getVoltage",186,186
1,1,8,0,0,"ServoRHA::getTemperature@187-187@/home/quique/Documentos/RHA/SW/lib/servo_rha/servo_rha.h","/home/quique/Documentos/RHA/SW/lib/servo_rha/servo_rha.h","ServoRHA::getTemperature",187,187
1,1,8,0,0,"ServoRHA::getGoalTorque@188-188@/home/quique/Documentos/RHA/SW/lib/servo_rha/servo_rha.h","/home/quique/Documentos/RHA/SW/lib/servo_rha/servo_rha.h","ServoRHA::getGoalTorque",188,188
1,1,8,0,0,"ServoRHA::getSpeedTarget@189-189@/home/quique/Documentos/RHA/SW/lib/servo_rha/servo_rha.h","/home/quique/Documentos/RHA/SW/lib/servo_rha/servo_rha.h","ServoRHA::getSpeedTarget",189,189
1,1,8,0,0,"ServoRHA::getSpeedSlope@190-190@/home/quique/Documentos/RHA/SW/lib/servo_rha/servo_rha.h","/home/quique/Documentos/RHA/SW/lib/servo_rha/servo_rha.h","ServoRHA::getSpeedSlope",190,190
1,1,8,0,0,"ServoRHA::getDirectionTarget@191-191@/home/quique/Documentos/RHA/SW/lib/servo_rha/servo_rha.h","/home/quique/Documentos/RHA/SW/lib/servo_rha/servo_rha.h","ServoRHA::getDirectionTarget",191,191
1,1,8,0,0,"ServoRHA::getError@192-192@/home/quique/Documentos/RHA/SW/lib/servo_rha/servo_rha.h","/home/quique/Documentos/RHA/SW/lib/servo_rha/servo_rha.h","ServoRHA::getError",192,192
1,1,8,0,0,"ServoRHA::getDError@193-193@/home/quique/Documentos/RHA/SW/lib/servo_rha/servo_rha.h","/home/quique/Documentos/RHA/SW/lib/servo_rha/servo_rha.h","ServoRHA::getDError",193,193
1,1,8,0,0,"ServoRHA::getIError@194-194@/home/quique/Documentos/RHA/SW/lib/servo_rha/servo_rha.h","/home/quique/Documentos/RHA/SW/lib/servo_rha/servo_rha.h","ServoRHA::getIError",194,194
3,1,13,1,2,"ServoRHA::ServoRHA@22-24@/home/quique/Documentos/RHA/SW/lib/servo_rha/servo_rha.cpp","/home/quique/Documentos/RHA/SW/lib/servo_rha/servo_rha.cpp","ServoRHA::ServoRHA",22,24
7,1,41,1,10,"ServoRHA::init@30-40@/home/quique/Documentos/RHA/SW/lib/servo_rha/servo_rha.cpp","/home/quique/Documentos/RHA/SW/lib/servo_rha/servo_rha.cpp","ServoRHA::init",30,40
18,1,159,2,30,"ServoRHA::updateInfo@64-94@/home/quique/Documentos/RHA/SW/lib/servo_rha/servo_rha.cpp","/home/quique/Documentos/RHA/SW/lib/servo_rha/servo_rha.cpp","ServoRHA::updateInfo",64,94
15,2,91,1,14,"ServoRHA::setSpeedGoal@103-117@/home/quique/Documentos/RHA/SW/lib/servo_rha/servo_rha.cpp","/home/quique/Documentos/RHA/SW/lib/servo_rha/servo_rha.cpp","ServoRHA::setSpeedGoal",103,117
13,1,96,0,18,"ServoRHA::speedError@122-140@/home/quique/Documentos/RHA/SW/lib/servo_rha/servo_rha.cpp","/home/quique/Documentos/RHA/SW/lib/servo_rha/servo_rha.cpp","ServoRHA::speedError",122,140
15,4,120,3,15,"ServoRHA::calculateTorque@149-164@/home/quique/Documentos/RHA/SW/lib/servo_rha/servo_rha.cpp","/home/quique/Documentos/RHA/SW/lib/servo_rha/servo_rha.cpp","ServoRHA::calculateTorque",149,164
6,1,41,1,5,"ServoRHA::addUpadteInfoToPacket@176-181@/home/quique/Documentos/RHA/SW/lib/servo_rha/servo_rha.cpp","/home/quique/Documentos/RHA/SW/lib/servo_rha/servo_rha.cpp","ServoRHA::addUpadteInfoToPacket",176,181
9,1,56,2,11,"ServoRHA::addReturnOptionToPacket@189-200@/home/quique/Documentos/RHA/SW/lib/servo_rha/servo_rha.cpp","/home/quique/Documentos/RHA/SW/lib/servo_rha/servo_rha.cpp","ServoRHA::addReturnOptionToPacket",189,200
14,2,86,1,15,"ServoRHA::addTorqueToPacket@207-222@/home/quique/Documentos/RHA/SW/lib/servo_rha/servo_rha.cpp","/home/quique/Documentos/RHA/SW/lib/servo_rha/servo_rha.cpp","ServoRHA::addTorqueToPacket",207,222
7,1,49,2,7,"ServoRHA::setTorqueOnOfToPacket@230-237@/home/quique/Documentos/RHA/SW/lib/servo_rha/servo_rha.cpp","/home/quique/Documentos/RHA/SW/lib/servo_rha/servo_rha.cpp","ServoRHA::setTorqueOnOfToPacket",230,237
4,1,24,1,3,"ServoRHA::setWheelModeToPacket@246-249@/home/quique/Documentos/RHA/SW/lib/servo_rha/servo_rha.cpp","/home/quique/Documentos/RHA/SW/lib/servo_rha/servo_rha.cpp","ServoRHA::setWheelModeToPacket",246,249
4,1,24,1,3,"ServoRHA::exitWheelModeToPacket@258-261@/home/quique/Documentos/RHA/SW/lib/servo_rha/servo_rha.cpp","/home/quique/Documentos/RHA/SW/lib/servo_rha/servo_rha.cpp","ServoRHA::exitWheelModeToPacket",258,261
9,1,78,3,10,"ServoRHA::wheelModeToPacket@271-281@/home/quique/Documentos/RHA/SW/lib/servo_rha/servo_rha.cpp","/home/quique/Documentos/RHA/SW/lib/servo_rha/servo_rha.cpp","ServoRHA::wheelModeToPacket",271,281
4,1,29,1,3,"ServoRHA::pingToPacket@288-291@/home/quique/Documentos/RHA/SW/lib/servo_rha/servo_rha.cpp","/home/quique/Documentos/RHA/SW/lib/servo_rha/servo_rha.cpp","ServoRHA::pingToPacket",288,291
8,1,61,2,8,"ServoRHA::setTorqueLimitToPacket@299-307@/home/quique/Documentos/RHA/SW/lib/servo_rha/servo_rha.cpp","/home/quique/Documentos/RHA/SW/lib/servo_rha/servo_rha.cpp","ServoRHA::setTorqueLimitToPacket",299,307
13,2,91,3,14,"ServoRHA::setWheelSpeedToPacket@316-330@/home/quique/Documentos/RHA/SW/lib/servo_rha/servo_rha.cpp","/home/quique/Documentos/RHA/SW/lib/servo_rha/servo_rha.cpp","ServoRHA::setWheelSpeedToPacket",316,330
9,2,69,3,10,"ServoRHA::addToPacket@338-348@/home/quique/Documentos/RHA/SW/lib/servo_rha/servo_rha.cpp","/home/quique/Documentos/RHA/SW/lib/servo_rha/servo_rha.cpp","ServoRHA::addToPacket",338,348
7,3,57,3,6,"compareAngles@361-367@/home/quique/Documentos/RHA/SW/lib/servo_rha/servo_rha.cpp","/home/quique/Documentos/RHA/SW/lib/servo_rha/servo_rha.cpp","compareAngles",361,367
7,3,57,3,6,"compareSpeed@375-381@/home/quique/Documentos/RHA/SW/lib/servo_rha/servo_rha.cpp","/home/quique/Documentos/RHA/SW/lib/servo_rha/servo_rha.cpp","compareSpeed",375,381
18,6,181,4,23,"MeasureUtilities::averageChauvenet@39-62@/home/quique/Documentos/RHA/SW/lib/utilities/utilities.cpp","/home/quique/Documentos/RHA/SW/lib/utilities/utilities.cpp","MeasureUtilities::averageChauvenet",39,62
15,3,108,1,24,"JHUtilitiesJH::initJoints@68-92@/home/quique/Documentos/RHA/SW/lib/utilities/utilities.cpp","/home/quique/Documentos/RHA/SW/lib/utilities/utilities.cpp","JHUtilitiesJH::initJoints",68,92
34,4,498,1,42,"JHUtilitiesJH::extractRegulatorData@99-141@/home/quique/Documentos/RHA/SW/lib/utilities/utilities.cpp","/home/quique/Documentos/RHA/SW/lib/utilities/utilities.cpp","JHUtilitiesJH::extractRegulatorData",99,141
13,2,82,2,12,"blinkLed@143-155@/home/quique/Documentos/RHA/SW/lib/utilities/utilities.cpp","/home/quique/Documentos/RHA/SW/lib/utilities/utilities.cpp","blinkLed",143,155
9,3,49,1,8,"testOnProcess@157-165@/home/quique/Documentos/RHA/SW/lib/utilities/utilities.cpp","/home/quique/Documentos/RHA/SW/lib/utilities/utilities.cpp","testOnProcess",157,165
8,1,31,0,7,"JHUtilitiesJH::resetEncoder@167-174@/home/quique/Documentos/RHA/SW/lib/utilities/utilities.cpp","/home/quique/Documentos/RHA/SW/lib/utilities/utilities.cpp","JHUtilitiesJH::resetEncoder",167,174
9,6,79,1,9,"JHUtilitiesJH::updateEncoder@178-187@/home/quique/Documentos/RHA/SW/lib/utilities/utilities.cpp","/home/quique/Documentos/RHA/SW/lib/utilities/utilities.cpp","JHUtilitiesJH::updateEncoder",178,187
5,1,30,1,4,"JHUtilitiesJH::startEncoder@189-193@/home/quique/Documentos/RHA/SW/lib/utilities/utilities.cpp","/home/quique/Documentos/RHA/SW/lib/utilities/utilities.cpp","JHUtilitiesJH::startEncoder",189,193
41,19,273,2,50,"JHUtilitiesJH::returnToStartPositionTest@195-245@/home/quique/Documentos/RHA/SW/lib/utilities/utilities.cpp","/home/quique/Documentos/RHA/SW/lib/utilities/utilities.cpp","JHUtilitiesJH::returnToStartPositionTest",195,245
91,19,744,2,108,"JHUtilitiesJH::extractStepSlopeData@248-356@/home/quique/Documentos/RHA/SW/lib/utilities/utilities.cpp","/home/quique/Documentos/RHA/SW/lib/utilities/utilities.cpp","JHUtilitiesJH::extractStepSlopeData",248,356
23,3,172,2,24,"JHUtilitiesJH::checkTimeGetInfo@364-388@/home/quique/Documentos/RHA/SW/lib/utilities/utilities.cpp","/home/quique/Documentos/RHA/SW/lib/utilities/utilities.cpp","JHUtilitiesJH::checkTimeGetInfo",364,388
12,3,75,1,12,"JHUtilitiesJH::checkComSucces@395-407@/home/quique/Documentos/RHA/SW/lib/utilities/utilities.cpp","/home/quique/Documentos/RHA/SW/lib/utilities/utilities.cpp","JHUtilitiesJH::checkComSucces",395,407
55,8,368,1,68,"JHUtilitiesJH::checkSpeed@413-481@/home/quique/Documentos/RHA/SW/lib/utilities/utilities.cpp","/home/quique/Documentos/RHA/SW/lib/utilities/utilities.cpp","JHUtilitiesJH::checkSpeed",413,481
3,1,9,0,2,"JHUtilitiesJH::JHUtilitiesJH@101-103@/home/quique/Documentos/RHA/SW/lib/utilities/utilities.h","/home/quique/Documentos/RHA/SW/lib/utilities/utilities.h","JHUtilitiesJH::JHUtilitiesJH",101,103
21,2,115,0,28,"WiiChuck::begin@78-106@/home/quique/Documentos/RHA/SW/lib/chuck_handler/WiiChuck.h","/home/quique/Documentos/RHA/SW/lib/chuck_handler/WiiChuck.h","WiiChuck::begin",78,106
4,1,13,0,3,"WiiChuck::calibrateJoy@109-112@/home/quique/Documentos/RHA/SW/lib/chuck_handler/WiiChuck.h","/home/quique/Documentos/RHA/SW/lib/chuck_handler/WiiChuck.h","WiiChuck::calibrateJoy",109,112
21,4,189,0,32,"WiiChuck::update@114-146@/home/quique/Documentos/RHA/SW/lib/chuck_handler/WiiChuck.h","/home/quique/Documentos/RHA/SW/lib/chuck_handler/WiiChuck.h","WiiChuck::update",114,146
3,1,16,0,3,"WiiChuck::readAccelX@154-157@/home/quique/Documentos/RHA/SW/lib/chuck_handler/WiiChuck.h","/home/quique/Documentos/RHA/SW/lib/chuck_handler/WiiChuck.h","WiiChuck::readAccelX",154,157
3,1,16,0,3,"WiiChuck::readAccelY@158-161@/home/quique/Documentos/RHA/SW/lib/chuck_handler/WiiChuck.h","/home/quique/Documentos/RHA/SW/lib/chuck_handler/WiiChuck.h","WiiChuck::readAccelY",158,161
3,1,16,0,3,"WiiChuck::readAccelZ@162-165@/home/quique/Documentos/RHA/SW/lib/chuck_handler/WiiChuck.h","/home/quique/Documentos/RHA/SW/lib/chuck_handler/WiiChuck.h","WiiChuck::readAccelZ",162,165
3,2,13,0,2,"WiiChuck::zPressed@167-169@/home/quique/Documentos/RHA/SW/lib/chuck_handler/WiiChuck.h","/home/quique/Documentos/RHA/SW/lib/chuck_handler/WiiChuck.h","WiiChuck::zPressed",167,169
3,2,13,0,2,"WiiChuck::cPressed@170-172@/home/quique/Documentos/RHA/SW/lib/chuck_handler/WiiChuck.h","/home/quique/Documentos/RHA/SW/lib/chuck_handler/WiiChuck.h","WiiChuck::cPressed",170,172
3,1,22,1,2,"WiiChuck::rightJoy@175-177@/home/quique/Documentos/RHA/SW/lib/chuck_handler/WiiChuck.h","/home/quique/Documentos/RHA/SW/lib/chuck_handler/WiiChuck.h","WiiChuck::rightJoy",175,177
3,1,24,1,2,"WiiChuck::leftJoy@180-182@/home/quique/Documentos/RHA/SW/lib/chuck_handler/WiiChuck.h","/home/quique/Documentos/RHA/SW/lib/chuck_handler/WiiChuck.h","WiiChuck::leftJoy",180,182
3,1,13,0,2,"WiiChuck::readJoyX@185-187@/home/quique/Documentos/RHA/SW/lib/chuck_handler/WiiChuck.h","/home/quique/Documentos/RHA/SW/lib/chuck_handler/WiiChuck.h","WiiChuck::readJoyX",185,187
3,1,13,0,2,"WiiChuck::readJoyY@189-191@/home/quique/Documentos/RHA/SW/lib/chuck_handler/WiiChuck.h","/home/quique/Documentos/RHA/SW/lib/chuck_handler/WiiChuck.h","WiiChuck::readJoyY",189,191
3,1,28,0,2,"WiiChuck::readRoll@201-203@/home/quique/Documentos/RHA/SW/lib/chuck_handler/WiiChuck.h","/home/quique/Documentos/RHA/SW/lib/chuck_handler/WiiChuck.h","WiiChuck::readRoll",201,203
3,1,26,0,2,"WiiChuck::readPitch@206-208@/home/quique/Documentos/RHA/SW/lib/chuck_handler/WiiChuck.h","/home/quique/Documentos/RHA/SW/lib/chuck_handler/WiiChuck.h","WiiChuck::readPitch",206,208
4,1,10,1,5,"WiiChuck::_nunchuk_decode_byte@211-216@/home/quique/Documentos/RHA/SW/lib/chuck_handler/WiiChuck.h","/home/quique/Documentos/RHA/SW/lib/chuck_handler/WiiChuck.h","WiiChuck::_nunchuk_decode_byte",211,216
6,1,28,0,5,"WiiChuck::_send_zero@218-223@/home/quique/Documentos/RHA/SW/lib/chuck_handler/WiiChuck.h","/home/quique/Documentos/RHA/SW/lib/chuck_handler/WiiChuck.h","WiiChuck::_send_zero",218,223
1,1,44,4,0,"ChuckReadStruct::ChuckReadStruct@14-14@/home/quique/Documentos/RHA/SW/lib/chuck_handler/chuck_handler.h","/home/quique/Documentos/RHA/SW/lib/chuck_handler/chuck_handler.h","ChuckReadStruct::ChuckReadStruct",14,14
3,1,11,0,2,"ChuckHandler::begin@23-25@/home/quique/Documentos/RHA/SW/lib/chuck_handler/chuck_handler.h","/home/quique/Documentos/RHA/SW/lib/chuck_handler/chuck_handler.h","ChuckHandler::begin",23,25
4,1,20,1,3,"ChuckHandler::setTimer@32-35@/home/quique/Documentos/RHA/SW/lib/chuck_handler/chuck_handler.h","/home/quique/Documentos/RHA/SW/lib/chuck_handler/chuck_handler.h","ChuckHandler::setTimer",32,35
7,1,79,0,6,"ChuckHandler::printChuckValues@37-43@/home/quique/Documentos/RHA/SW/lib/chuck_handler/chuck_handler.h","/home/quique/Documentos/RHA/SW/lib/chuck_handler/chuck_handler.h","ChuckHandler::printChuckValues",37,43
33,13,328,0,45,"ChuckHandler::readAxis@50-95@/home/quique/Documentos/RHA/SW/lib/chuck_handler/chuck_handler.h","/home/quique/Documentos/RHA/SW/lib/chuck_handler/chuck_handler.h","ChuckHandler::readAxis",50,95
18,15,219,2,18,"printServoStatusError@14-32@/home/quique/Documentos/RHA/SW/lib/debug/debug.cpp","/home/quique/Documentos/RHA/SW/lib/debug/debug.cpp","printServoStatusError",14,32
13,1,161,8,12,"printServoStatus@34-46@/home/quique/Documentos/RHA/SW/lib/debug/debug.cpp","/home/quique/Documentos/RHA/SW/lib/debug/debug.cpp","printServoStatus",34,46
