3,1,29,4,2,"ServoRHA::ServoRHA@10-12@/home/gmv/RHA/SW/lib/servo_rha/servo_rha.cpp","/home/gmv/RHA/SW/lib/servo_rha/servo_rha.cpp","ServoRHA::ServoRHA",10,12
9,1,64,5,12,"ServoRHA::init@17-29@/home/gmv/RHA/SW/lib/servo_rha/servo_rha.cpp","/home/gmv/RHA/SW/lib/servo_rha/servo_rha.cpp","ServoRHA::init",17,29
9,1,42,0,13,"ServoRHA::init@31-44@/home/gmv/RHA/SW/lib/servo_rha/servo_rha.cpp","/home/gmv/RHA/SW/lib/servo_rha/servo_rha.cpp","ServoRHA::init",31,44
10,1,64,0,9,"ServoRHA::angleRead@53-62@/home/gmv/RHA/SW/lib/servo_rha/servo_rha.cpp","/home/gmv/RHA/SW/lib/servo_rha/servo_rha.cpp","ServoRHA::angleRead",53,62
9,1,52,0,9,"ServoRHA::speedRead@67-76@/home/gmv/RHA/SW/lib/servo_rha/servo_rha.cpp","/home/gmv/RHA/SW/lib/servo_rha/servo_rha.cpp","ServoRHA::speedRead",67,76
7,2,37,0,6,"ServoRHA::isMoving@81-87@/home/gmv/RHA/SW/lib/servo_rha/servo_rha.cpp","/home/gmv/RHA/SW/lib/servo_rha/servo_rha.cpp","ServoRHA::isMoving",81,87
4,1,19,0,3,"ServoRHA::updateInfo@90-93@/home/gmv/RHA/SW/lib/servo_rha/servo_rha.cpp","/home/gmv/RHA/SW/lib/servo_rha/servo_rha.cpp","ServoRHA::updateInfo",90,93
8,1,53,1,10,"ServoRHA::returnPacketSet@99-109@/home/gmv/RHA/SW/lib/servo_rha/servo_rha.cpp","/home/gmv/RHA/SW/lib/servo_rha/servo_rha.cpp","ServoRHA::returnPacketSet",99,109
11,2,77,5,10,"ServoRHA::addToPacket@123-133@/home/gmv/RHA/SW/lib/servo_rha/servo_rha.cpp","/home/gmv/RHA/SW/lib/servo_rha/servo_rha.cpp","ServoRHA::addToPacket",123,133
19,2,182,5,19,"ServoRHA::wrapPacket@143-162@/home/gmv/RHA/SW/lib/servo_rha/servo_rha.cpp","/home/gmv/RHA/SW/lib/servo_rha/servo_rha.cpp","ServoRHA::wrapPacket",143,162
8,1,45,0,7,"ServoRHA::calibrateTorque@172-179@/home/gmv/RHA/SW/lib/servo_rha/servo_rha.cpp","/home/gmv/RHA/SW/lib/servo_rha/servo_rha.cpp","ServoRHA::calibrateTorque",172,179
13,3,87,2,15,"ServoRHA::calibrateTorqueDir@185-200@/home/gmv/RHA/SW/lib/servo_rha/servo_rha.cpp","/home/gmv/RHA/SW/lib/servo_rha/servo_rha.cpp","ServoRHA::calibrateTorqueDir",185,200
10,6,134,2,10,"ServoRHA::setWheelSpeed@214-224@/home/gmv/RHA/SW/lib/servo_rha/servo_rha.cpp","/home/gmv/RHA/SW/lib/servo_rha/servo_rha.cpp","ServoRHA::setWheelSpeed",214,224
3,1,12,1,2,"regulator@231-233@/home/gmv/RHA/SW/lib/servo_rha/servo_rha.cpp","/home/gmv/RHA/SW/lib/servo_rha/servo_rha.cpp","regulator",231,233
6,3,51,3,5,"compareAngles@246-251@/home/gmv/RHA/SW/lib/servo_rha/servo_rha.cpp","/home/gmv/RHA/SW/lib/servo_rha/servo_rha.cpp","compareAngles",246,251
6,3,51,3,5,"compareSpeed@259-264@/home/gmv/RHA/SW/lib/servo_rha/servo_rha.cpp","/home/gmv/RHA/SW/lib/servo_rha/servo_rha.cpp","compareSpeed",259,264
1,1,5,0,0,"ServoRHA::ServoRHA@43-43@/home/gmv/RHA/SW/lib/servo_rha/servo_rha.h","/home/gmv/RHA/SW/lib/servo_rha/servo_rha.h","ServoRHA::ServoRHA",43,43
4,1,23,3,4,"JointRHA::JointRHA@7-11@/home/gmv/RHA/SW/lib/joint_rha/joint_rha.cpp","/home/gmv/RHA/SW/lib/joint_rha/joint_rha.cpp","JointRHA::JointRHA",7,11
2,1,7,0,2,"JointRHA::~JointRHA@15-17@/home/gmv/RHA/SW/lib/joint_rha/joint_rha.cpp","/home/gmv/RHA/SW/lib/joint_rha/joint_rha.cpp","JointRHA::~JointRHA",15,17
5,1,30,3,7,"JointRHA::init@19-26@/home/gmv/RHA/SW/lib/joint_rha/joint_rha.cpp","/home/gmv/RHA/SW/lib/joint_rha/joint_rha.cpp","JointRHA::init",19,26
3,1,14,0,3,"JointRHA::updateInfo@29-32@/home/gmv/RHA/SW/lib/joint_rha/joint_rha.cpp","/home/gmv/RHA/SW/lib/joint_rha/joint_rha.cpp","JointRHA::updateInfo",29,32
5,1,25,3,4,"initCytronG15Shield@26-30@/home/gmv/RHA/SW/lib/cytron_g15_servo/cytron_g15_servo.cpp","/home/gmv/RHA/SW/lib/cytron_g15_servo/cytron_g15_servo.cpp","initCytronG15Shield",26,30
4,1,31,4,3,"Cytron_G15_Servo::Cytron_G15_Servo@32-35@/home/gmv/RHA/SW/lib/cytron_g15_servo/cytron_g15_servo.cpp","/home/gmv/RHA/SW/lib/cytron_g15_servo/cytron_g15_servo.cpp","Cytron_G15_Servo::Cytron_G15_Servo",32,35
3,1,24,3,2,"Cytron_G15_Servo::Cytron_G15_Servo@37-39@/home/gmv/RHA/SW/lib/cytron_g15_servo/cytron_g15_servo.cpp","/home/gmv/RHA/SW/lib/cytron_g15_servo/cytron_g15_servo.cpp","Cytron_G15_Servo::Cytron_G15_Servo",37,39
3,1,18,1,2,"Cytron_G15_Servo::Cytron_G15_Servo@41-43@/home/gmv/RHA/SW/lib/cytron_g15_servo/cytron_g15_servo.cpp","/home/gmv/RHA/SW/lib/cytron_g15_servo/cytron_g15_servo.cpp","Cytron_G15_Servo::Cytron_G15_Servo",41,43
5,1,39,5,4,"Cytron_G15_Servo::init@45-49@/home/gmv/RHA/SW/lib/cytron_g15_servo/cytron_g15_servo.cpp","/home/gmv/RHA/SW/lib/cytron_g15_servo/cytron_g15_servo.cpp","Cytron_G15_Servo::init",45,49
17,4,102,1,16,"Cytron_G15_Servo::begin@51-67@/home/gmv/RHA/SW/lib/cytron_g15_servo/cytron_g15_servo.cpp","/home/gmv/RHA/SW/lib/cytron_g15_servo/cytron_g15_servo.cpp","Cytron_G15_Servo::begin",51,67
10,3,56,1,9,"Cytron_G15_Servo::end@69-78@/home/gmv/RHA/SW/lib/cytron_g15_servo/cytron_g15_servo.cpp","/home/gmv/RHA/SW/lib/cytron_g15_servo/cytron_g15_servo.cpp","Cytron_G15_Servo::end",69,78
3,1,15,1,2,"Cytron_G15_Servo::setTxMode@80-82@/home/gmv/RHA/SW/lib/cytron_g15_servo/cytron_g15_servo.cpp","/home/gmv/RHA/SW/lib/cytron_g15_servo/cytron_g15_servo.cpp","Cytron_G15_Servo::setTxMode",80,82
3,1,15,1,2,"Cytron_G15_Servo::setRxMode@84-86@/home/gmv/RHA/SW/lib/cytron_g15_servo/cytron_g15_servo.cpp","/home/gmv/RHA/SW/lib/cytron_g15_servo/cytron_g15_servo.cpp","Cytron_G15_Servo::setRxMode",84,86
78,21,528,4,90,"Cytron_G15_Servo::sendPacket@90-180@/home/gmv/RHA/SW/lib/cytron_g15_servo/cytron_g15_servo.cpp","/home/gmv/RHA/SW/lib/cytron_g15_servo/cytron_g15_servo.cpp","Cytron_G15_Servo::sendPacket",90,180
9,2,48,0,9,"Cytron_G15_Servo::setWheelMode@182-191@/home/gmv/RHA/SW/lib/cytron_g15_servo/cytron_g15_servo.cpp","/home/gmv/RHA/SW/lib/cytron_g15_servo/cytron_g15_servo.cpp","Cytron_G15_Servo::setWheelMode",182,191
3,1,17,0,2,"Cytron_G15_Servo::exitWheelMode@193-195@/home/gmv/RHA/SW/lib/cytron_g15_servo/cytron_g15_servo.cpp","/home/gmv/RHA/SW/lib/cytron_g15_servo/cytron_g15_servo.cpp","Cytron_G15_Servo::exitWheelMode",193,195
7,2,45,3,6,"Cytron_G15_Servo::setWheelSpeed@197-203@/home/gmv/RHA/SW/lib/cytron_g15_servo/cytron_g15_servo.cpp","/home/gmv/RHA/SW/lib/cytron_g15_servo/cytron_g15_servo.cpp","Cytron_G15_Servo::setWheelSpeed",197,203
7,1,58,2,8,"Cytron_G15_Servo::setPos@211-219@/home/gmv/RHA/SW/lib/cytron_g15_servo/cytron_g15_servo.cpp","/home/gmv/RHA/SW/lib/cytron_g15_servo/cytron_g15_servo.cpp","Cytron_G15_Servo::setPos",211,219
8,1,66,2,9,"Cytron_G15_Servo::setPosAngle@221-230@/home/gmv/RHA/SW/lib/cytron_g15_servo/cytron_g15_servo.cpp","/home/gmv/RHA/SW/lib/cytron_g15_servo/cytron_g15_servo.cpp","Cytron_G15_Servo::setPosAngle",221,230
9,1,80,3,10,"Cytron_G15_Servo::setPosSpeed@232-242@/home/gmv/RHA/SW/lib/cytron_g15_servo/cytron_g15_servo.cpp","/home/gmv/RHA/SW/lib/cytron_g15_servo/cytron_g15_servo.cpp","Cytron_G15_Servo::setPosSpeed",232,242
4,1,28,2,4,"Cytron_G15_Servo::rotateCW@244-248@/home/gmv/RHA/SW/lib/cytron_g15_servo/cytron_g15_servo.cpp","/home/gmv/RHA/SW/lib/cytron_g15_servo/cytron_g15_servo.cpp","Cytron_G15_Servo::rotateCW",244,248
5,1,34,2,5,"Cytron_G15_Servo::rotateCCW@250-255@/home/gmv/RHA/SW/lib/cytron_g15_servo/cytron_g15_servo.cpp","/home/gmv/RHA/SW/lib/cytron_g15_servo/cytron_g15_servo.cpp","Cytron_G15_Servo::rotateCCW",250,255
6,1,46,2,7,"Cytron_G15_Servo::setTorqueOnOff@261-268@/home/gmv/RHA/SW/lib/cytron_g15_servo/cytron_g15_servo.cpp","/home/gmv/RHA/SW/lib/cytron_g15_servo/cytron_g15_servo.cpp","Cytron_G15_Servo::setTorqueOnOff",261,268
7,1,58,2,8,"Cytron_G15_Servo::setSpeed@276-284@/home/gmv/RHA/SW/lib/cytron_g15_servo/cytron_g15_servo.cpp","/home/gmv/RHA/SW/lib/cytron_g15_servo/cytron_g15_servo.cpp","Cytron_G15_Servo::setSpeed",276,284
5,1,34,2,5,"Cytron_G15_Servo::setTimeToGoal@287-292@/home/gmv/RHA/SW/lib/cytron_g15_servo/cytron_g15_servo.cpp","/home/gmv/RHA/SW/lib/cytron_g15_servo/cytron_g15_servo.cpp","Cytron_G15_Servo::setTimeToGoal",287,292
12,1,89,2,13,"Cytron_G15_Servo::setAngleLimit@303-316@/home/gmv/RHA/SW/lib/cytron_g15_servo/cytron_g15_servo.cpp","/home/gmv/RHA/SW/lib/cytron_g15_servo/cytron_g15_servo.cpp","Cytron_G15_Servo::setAngleLimit",303,316
7,1,55,1,8,"Cytron_G15_Servo::setTorqueLimit@318-326@/home/gmv/RHA/SW/lib/cytron_g15_servo/cytron_g15_servo.cpp","/home/gmv/RHA/SW/lib/cytron_g15_servo/cytron_g15_servo.cpp","Cytron_G15_Servo::setTorqueLimit",318,326
9,1,55,1,10,"Cytron_G15_Servo::setTemperatureLimit@328-338@/home/gmv/RHA/SW/lib/cytron_g15_servo/cytron_g15_servo.cpp","/home/gmv/RHA/SW/lib/cytron_g15_servo/cytron_g15_servo.cpp","Cytron_G15_Servo::setTemperatureLimit",328,338
10,1,65,2,11,"Cytron_G15_Servo::setVoltageLimit@340-351@/home/gmv/RHA/SW/lib/cytron_g15_servo/cytron_g15_servo.cpp","/home/gmv/RHA/SW/lib/cytron_g15_servo/cytron_g15_servo.cpp","Cytron_G15_Servo::setVoltageLimit",340,351
9,1,55,1,10,"Cytron_G15_Servo::setID@357-367@/home/gmv/RHA/SW/lib/cytron_g15_servo/cytron_g15_servo.cpp","/home/gmv/RHA/SW/lib/cytron_g15_servo/cytron_g15_servo.cpp","Cytron_G15_Servo::setID",357,367
6,1,46,2,7,"Cytron_G15_Servo::setLED@373-380@/home/gmv/RHA/SW/lib/cytron_g15_servo/cytron_g15_servo.cpp","/home/gmv/RHA/SW/lib/cytron_g15_servo/cytron_g15_servo.cpp","Cytron_G15_Servo::setLED",373,380
11,1,66,1,13,"Cytron_G15_Servo::setAlarmLED@382-395@/home/gmv/RHA/SW/lib/cytron_g15_servo/cytron_g15_servo.cpp","/home/gmv/RHA/SW/lib/cytron_g15_servo/cytron_g15_servo.cpp","Cytron_G15_Servo::setAlarmLED",382,395
11,1,66,1,13,"Cytron_G15_Servo::setAlarmShutDown@397-410@/home/gmv/RHA/SW/lib/cytron_g15_servo/cytron_g15_servo.cpp","/home/gmv/RHA/SW/lib/cytron_g15_servo/cytron_g15_servo.cpp","Cytron_G15_Servo::setAlarmShutDown",397,410
18,2,137,5,23,"Cytron_G15_Servo::setMarginSlopePunch@412-435@/home/gmv/RHA/SW/lib/cytron_g15_servo/cytron_g15_servo.cpp","/home/gmv/RHA/SW/lib/cytron_g15_servo/cytron_g15_servo.cpp","Cytron_G15_Servo::setMarginSlopePunch",412,435
9,1,61,1,10,"Cytron_G15_Servo::setBaudRate@441-451@/home/gmv/RHA/SW/lib/cytron_g15_servo/cytron_g15_servo.cpp","/home/gmv/RHA/SW/lib/cytron_g15_servo/cytron_g15_servo.cpp","Cytron_G15_Servo::setBaudRate",441,451
7,1,39,0,7,"Cytron_G15_Servo::factoryReset@457-464@/home/gmv/RHA/SW/lib/cytron_g15_servo/cytron_g15_servo.cpp","/home/gmv/RHA/SW/lib/cytron_g15_servo/cytron_g15_servo.cpp","Cytron_G15_Servo::factoryReset",457,464
3,1,24,1,2,"Cytron_G15_Servo::ping@469-471@/home/gmv/RHA/SW/lib/cytron_g15_servo/cytron_g15_servo.cpp","/home/gmv/RHA/SW/lib/cytron_g15_servo/cytron_g15_servo.cpp","Cytron_G15_Servo::ping",469,471
5,1,38,1,5,"Cytron_G15_Servo::getPos@476-481@/home/gmv/RHA/SW/lib/cytron_g15_servo/cytron_g15_servo.cpp","/home/gmv/RHA/SW/lib/cytron_g15_servo/cytron_g15_servo.cpp","Cytron_G15_Servo::getPos",476,481
5,1,38,1,5,"Cytron_G15_Servo::getSpeed@483-488@/home/gmv/RHA/SW/lib/cytron_g15_servo/cytron_g15_servo.cpp","/home/gmv/RHA/SW/lib/cytron_g15_servo/cytron_g15_servo.cpp","Cytron_G15_Servo::getSpeed",483,488
5,1,38,1,5,"Cytron_G15_Servo::getLoad@490-495@/home/gmv/RHA/SW/lib/cytron_g15_servo/cytron_g15_servo.cpp","/home/gmv/RHA/SW/lib/cytron_g15_servo/cytron_g15_servo.cpp","Cytron_G15_Servo::getLoad",490,495
5,1,38,1,5,"Cytron_G15_Servo::getVoltage@497-502@/home/gmv/RHA/SW/lib/cytron_g15_servo/cytron_g15_servo.cpp","/home/gmv/RHA/SW/lib/cytron_g15_servo/cytron_g15_servo.cpp","Cytron_G15_Servo::getVoltage",497,502
5,1,38,1,5,"Cytron_G15_Servo::getTemperature@504-509@/home/gmv/RHA/SW/lib/cytron_g15_servo/cytron_g15_servo.cpp","/home/gmv/RHA/SW/lib/cytron_g15_servo/cytron_g15_servo.cpp","Cytron_G15_Servo::getTemperature",504,509
5,1,38,1,5,"Cytron_G15_Servo::getTorqueOnOff@514-519@/home/gmv/RHA/SW/lib/cytron_g15_servo/cytron_g15_servo.cpp","/home/gmv/RHA/SW/lib/cytron_g15_servo/cytron_g15_servo.cpp","Cytron_G15_Servo::getTorqueOnOff",514,519
5,1,38,1,5,"Cytron_G15_Servo::isMoving@524-529@/home/gmv/RHA/SW/lib/cytron_g15_servo/cytron_g15_servo.cpp","/home/gmv/RHA/SW/lib/cytron_g15_servo/cytron_g15_servo.cpp","Cytron_G15_Servo::isMoving",524,529
3,1,13,1,4,"Cytron_G15_Servo::setAction@537-541@/home/gmv/RHA/SW/lib/cytron_g15_servo/cytron_g15_servo.cpp","/home/gmv/RHA/SW/lib/cytron_g15_servo/cytron_g15_servo.cpp","Cytron_G15_Servo::setAction",537,541
25,4,178,1,30,"set_act@543-573@/home/gmv/RHA/SW/lib/cytron_g15_servo/cytron_g15_servo.cpp","/home/gmv/RHA/SW/lib/cytron_g15_servo/cytron_g15_servo.cpp","set_act",543,573
1,1,5,0,0,"Cytron_G15_Servo::Cytron_G15_Servo@143-143@/home/gmv/RHA/SW/lib/cytron_g15_servo/cytron_g15_servo.h","/home/gmv/RHA/SW/lib/cytron_g15_servo/cytron_g15_servo.h","Cytron_G15_Servo::Cytron_G15_Servo",143,143
3,1,13,1,2,"JointHandler::JointHandler@4-6@/home/gmv/RHA/SW/lib/joint_handler/joint_handler.cpp","/home/gmv/RHA/SW/lib/joint_handler/joint_handler.cpp","JointHandler::JointHandler",4,6
4,1,24,1,3,"JointHandler::init@8-11@/home/gmv/RHA/SW/lib/joint_handler/joint_handler.cpp","/home/gmv/RHA/SW/lib/joint_handler/joint_handler.cpp","JointHandler::init",8,11
5,2,25,0,12,"JointHandler::controlLoop@13-25@/home/gmv/RHA/SW/lib/joint_handler/joint_handler.cpp","/home/gmv/RHA/SW/lib/joint_handler/joint_handler.cpp","JointHandler::controlLoop",13,25
6,1,31,0,7,"setup@16-23@/home/gmv/RHA/SW/src/main.cpp","/home/gmv/RHA/SW/src/main.cpp","setup",16,23
12,2,73,0,17,"loop@26-43@/home/gmv/RHA/SW/src/main.cpp","/home/gmv/RHA/SW/src/main.cpp","loop",26,43
