3,1,29,4,2,"ServoRHA::ServoRHA@9-11@/home/gmv/RHA/SW/lib/servo_rha/servo_rha.cpp","/home/gmv/RHA/SW/lib/servo_rha/servo_rha.cpp","ServoRHA::ServoRHA",9,11
17,1,104,0,20,"ServoRHA::initServo@15-35@/home/gmv/RHA/SW/lib/servo_rha/servo_rha.cpp","/home/gmv/RHA/SW/lib/servo_rha/servo_rha.cpp","ServoRHA::initServo",15,35
9,1,58,0,8,"ServoRHA::angleRead@45-53@/home/gmv/RHA/SW/lib/servo_rha/servo_rha.cpp","/home/gmv/RHA/SW/lib/servo_rha/servo_rha.cpp","ServoRHA::angleRead",45,53
9,1,55,0,8,"ServoRHA::speedRead@58-66@/home/gmv/RHA/SW/lib/servo_rha/servo_rha.cpp","/home/gmv/RHA/SW/lib/servo_rha/servo_rha.cpp","ServoRHA::speedRead",58,66
8,1,53,1,10,"ServoRHA::returnPacketSet@72-82@/home/gmv/RHA/SW/lib/servo_rha/servo_rha.cpp","/home/gmv/RHA/SW/lib/servo_rha/servo_rha.cpp","ServoRHA::returnPacketSet",72,82
11,2,77,5,10,"ServoRHA::addToPacket@96-106@/home/gmv/RHA/SW/lib/servo_rha/servo_rha.cpp","/home/gmv/RHA/SW/lib/servo_rha/servo_rha.cpp","ServoRHA::addToPacket",96,106
19,2,182,5,19,"ServoRHA::wrapPacket@116-135@/home/gmv/RHA/SW/lib/servo_rha/servo_rha.cpp","/home/gmv/RHA/SW/lib/servo_rha/servo_rha.cpp","ServoRHA::wrapPacket",116,135
8,1,45,0,7,"ServoRHA::calibrateTorque@144-151@/home/gmv/RHA/SW/lib/servo_rha/servo_rha.cpp","/home/gmv/RHA/SW/lib/servo_rha/servo_rha.cpp","ServoRHA::calibrateTorque",144,151
13,3,87,2,15,"ServoRHA::calibrateTorqueDir@157-172@/home/gmv/RHA/SW/lib/servo_rha/servo_rha.cpp","/home/gmv/RHA/SW/lib/servo_rha/servo_rha.cpp","ServoRHA::calibrateTorqueDir",157,172
10,6,134,2,10,"ServoRHA::setWheelSpeed@185-195@/home/gmv/RHA/SW/lib/servo_rha/servo_rha.cpp","/home/gmv/RHA/SW/lib/servo_rha/servo_rha.cpp","ServoRHA::setWheelSpeed",185,195
6,1,30,2,5,"ServoRHA::setGoalEncoder@207-212@/home/gmv/RHA/SW/lib/servo_rha/servo_rha.cpp","/home/gmv/RHA/SW/lib/servo_rha/servo_rha.cpp","ServoRHA::setGoalEncoder",207,212
7,3,33,0,7,"ServoRHA::doNext@216-223@/home/gmv/RHA/SW/lib/servo_rha/servo_rha.cpp","/home/gmv/RHA/SW/lib/servo_rha/servo_rha.cpp","ServoRHA::doNext",216,223
37,13,253,0,45,"ServoRHA::encoderModeRotation@228-273@/home/gmv/RHA/SW/lib/servo_rha/servo_rha.cpp","/home/gmv/RHA/SW/lib/servo_rha/servo_rha.cpp","ServoRHA::encoderModeRotation",228,273
10,6,89,1,11,"ServoRHA::accelerate@277-288@/home/gmv/RHA/SW/lib/servo_rha/servo_rha.cpp","/home/gmv/RHA/SW/lib/servo_rha/servo_rha.cpp","ServoRHA::accelerate",277,288
16,6,108,2,18,"ServoRHA::decelerate@292-310@/home/gmv/RHA/SW/lib/servo_rha/servo_rha.cpp","/home/gmv/RHA/SW/lib/servo_rha/servo_rha.cpp","ServoRHA::decelerate",292,310
7,2,37,0,6,"ServoRHA::isMoving@315-321@/home/gmv/RHA/SW/lib/servo_rha/servo_rha.cpp","/home/gmv/RHA/SW/lib/servo_rha/servo_rha.cpp","ServoRHA::isMoving",315,321
6,3,51,3,5,"compareAngles@333-338@/home/gmv/RHA/SW/lib/servo_rha/servo_rha.cpp","/home/gmv/RHA/SW/lib/servo_rha/servo_rha.cpp","compareAngles",333,338
6,3,51,3,5,"compareSpeed@346-351@/home/gmv/RHA/SW/lib/servo_rha/servo_rha.cpp","/home/gmv/RHA/SW/lib/servo_rha/servo_rha.cpp","compareSpeed",346,351
1,1,5,0,0,"ServoRHA::ServoRHA@53-53@/home/gmv/RHA/SW/lib/servo_rha/servo_rha.h","/home/gmv/RHA/SW/lib/servo_rha/servo_rha.h","ServoRHA::ServoRHA",53,53
4,1,23,3,4,"JointRHA::JointRHA@7-11@/home/gmv/RHA/SW/lib/joint_rha/joint_rha.cpp","/home/gmv/RHA/SW/lib/joint_rha/joint_rha.cpp","JointRHA::JointRHA",7,11
2,1,7,0,2,"JointRHA::~JointRHA@15-17@/home/gmv/RHA/SW/lib/joint_rha/joint_rha.cpp","/home/gmv/RHA/SW/lib/joint_rha/joint_rha.cpp","JointRHA::~JointRHA",15,17
3,1,14,0,2,"JointRHA::initJoint@19-21@/home/gmv/RHA/SW/lib/joint_rha/joint_rha.cpp","/home/gmv/RHA/SW/lib/joint_rha/joint_rha.cpp","JointRHA::initJoint",19,21
3,1,13,0,2,"JointRHA::readFeedbackPosition@23-25@/home/gmv/RHA/SW/lib/joint_rha/joint_rha.cpp","/home/gmv/RHA/SW/lib/joint_rha/joint_rha.cpp","JointRHA::readFeedbackPosition",23,25
6,1,34,4,5,"Cytron_G15Shield::Cytron_G15Shield@23-28@/home/gmv/RHA/SW/lib/Cytron_G15Shield/Cytron_G15Shield.cpp","/home/gmv/RHA/SW/lib/Cytron_G15Shield/Cytron_G15Shield.cpp","Cytron_G15Shield::Cytron_G15Shield",23,28
5,1,27,3,4,"Cytron_G15Shield::Cytron_G15Shield@30-34@/home/gmv/RHA/SW/lib/Cytron_G15Shield/Cytron_G15Shield.cpp","/home/gmv/RHA/SW/lib/Cytron_G15Shield/Cytron_G15Shield.cpp","Cytron_G15Shield::Cytron_G15Shield",30,34
5,1,21,1,4,"Cytron_G15Shield::Cytron_G15Shield@36-40@/home/gmv/RHA/SW/lib/Cytron_G15Shield/Cytron_G15Shield.cpp","/home/gmv/RHA/SW/lib/Cytron_G15Shield/Cytron_G15Shield.cpp","Cytron_G15Shield::Cytron_G15Shield",36,40
17,4,102,1,16,"Cytron_G15Shield::begin@42-58@/home/gmv/RHA/SW/lib/Cytron_G15Shield/Cytron_G15Shield.cpp","/home/gmv/RHA/SW/lib/Cytron_G15Shield/Cytron_G15Shield.cpp","Cytron_G15Shield::begin",42,58
10,3,56,1,9,"Cytron_G15Shield::end@60-69@/home/gmv/RHA/SW/lib/Cytron_G15Shield/Cytron_G15Shield.cpp","/home/gmv/RHA/SW/lib/Cytron_G15Shield/Cytron_G15Shield.cpp","Cytron_G15Shield::end",60,69
3,1,15,1,2,"Cytron_G15Shield::setTxMode@71-73@/home/gmv/RHA/SW/lib/Cytron_G15Shield/Cytron_G15Shield.cpp","/home/gmv/RHA/SW/lib/Cytron_G15Shield/Cytron_G15Shield.cpp","Cytron_G15Shield::setTxMode",71,73
3,1,15,1,2,"Cytron_G15Shield::setRxMode@75-77@/home/gmv/RHA/SW/lib/Cytron_G15Shield/Cytron_G15Shield.cpp","/home/gmv/RHA/SW/lib/Cytron_G15Shield/Cytron_G15Shield.cpp","Cytron_G15Shield::setRxMode",75,77
78,21,528,4,90,"Cytron_G15Shield::sendPacket@81-171@/home/gmv/RHA/SW/lib/Cytron_G15Shield/Cytron_G15Shield.cpp","/home/gmv/RHA/SW/lib/Cytron_G15Shield/Cytron_G15Shield.cpp","Cytron_G15Shield::sendPacket",81,171
9,2,48,0,9,"Cytron_G15Shield::setWheelMode@173-182@/home/gmv/RHA/SW/lib/Cytron_G15Shield/Cytron_G15Shield.cpp","/home/gmv/RHA/SW/lib/Cytron_G15Shield/Cytron_G15Shield.cpp","Cytron_G15Shield::setWheelMode",173,182
3,1,17,0,2,"Cytron_G15Shield::exitWheelMode@184-186@/home/gmv/RHA/SW/lib/Cytron_G15Shield/Cytron_G15Shield.cpp","/home/gmv/RHA/SW/lib/Cytron_G15Shield/Cytron_G15Shield.cpp","Cytron_G15Shield::exitWheelMode",184,186
7,2,45,3,6,"Cytron_G15Shield::setWheelSpeed@188-194@/home/gmv/RHA/SW/lib/Cytron_G15Shield/Cytron_G15Shield.cpp","/home/gmv/RHA/SW/lib/Cytron_G15Shield/Cytron_G15Shield.cpp","Cytron_G15Shield::setWheelSpeed",188,194
7,1,58,2,8,"Cytron_G15Shield::setPos@202-210@/home/gmv/RHA/SW/lib/Cytron_G15Shield/Cytron_G15Shield.cpp","/home/gmv/RHA/SW/lib/Cytron_G15Shield/Cytron_G15Shield.cpp","Cytron_G15Shield::setPos",202,210
8,1,66,2,9,"Cytron_G15Shield::setPosAngle@212-221@/home/gmv/RHA/SW/lib/Cytron_G15Shield/Cytron_G15Shield.cpp","/home/gmv/RHA/SW/lib/Cytron_G15Shield/Cytron_G15Shield.cpp","Cytron_G15Shield::setPosAngle",212,221
9,1,80,3,10,"Cytron_G15Shield::setPosSpeed@223-233@/home/gmv/RHA/SW/lib/Cytron_G15Shield/Cytron_G15Shield.cpp","/home/gmv/RHA/SW/lib/Cytron_G15Shield/Cytron_G15Shield.cpp","Cytron_G15Shield::setPosSpeed",223,233
4,1,28,2,4,"Cytron_G15Shield::rotateCW@235-239@/home/gmv/RHA/SW/lib/Cytron_G15Shield/Cytron_G15Shield.cpp","/home/gmv/RHA/SW/lib/Cytron_G15Shield/Cytron_G15Shield.cpp","Cytron_G15Shield::rotateCW",235,239
5,1,34,2,5,"Cytron_G15Shield::rotateCCW@241-246@/home/gmv/RHA/SW/lib/Cytron_G15Shield/Cytron_G15Shield.cpp","/home/gmv/RHA/SW/lib/Cytron_G15Shield/Cytron_G15Shield.cpp","Cytron_G15Shield::rotateCCW",241,246
6,1,46,2,7,"Cytron_G15Shield::setTorqueOnOff@252-259@/home/gmv/RHA/SW/lib/Cytron_G15Shield/Cytron_G15Shield.cpp","/home/gmv/RHA/SW/lib/Cytron_G15Shield/Cytron_G15Shield.cpp","Cytron_G15Shield::setTorqueOnOff",252,259
7,1,58,2,8,"Cytron_G15Shield::setSpeed@267-275@/home/gmv/RHA/SW/lib/Cytron_G15Shield/Cytron_G15Shield.cpp","/home/gmv/RHA/SW/lib/Cytron_G15Shield/Cytron_G15Shield.cpp","Cytron_G15Shield::setSpeed",267,275
5,1,34,2,5,"Cytron_G15Shield::setTimeToGoal@278-283@/home/gmv/RHA/SW/lib/Cytron_G15Shield/Cytron_G15Shield.cpp","/home/gmv/RHA/SW/lib/Cytron_G15Shield/Cytron_G15Shield.cpp","Cytron_G15Shield::setTimeToGoal",278,283
12,1,89,2,13,"Cytron_G15Shield::setAngleLimit@294-307@/home/gmv/RHA/SW/lib/Cytron_G15Shield/Cytron_G15Shield.cpp","/home/gmv/RHA/SW/lib/Cytron_G15Shield/Cytron_G15Shield.cpp","Cytron_G15Shield::setAngleLimit",294,307
7,1,55,1,8,"Cytron_G15Shield::setTorqueLimit@309-317@/home/gmv/RHA/SW/lib/Cytron_G15Shield/Cytron_G15Shield.cpp","/home/gmv/RHA/SW/lib/Cytron_G15Shield/Cytron_G15Shield.cpp","Cytron_G15Shield::setTorqueLimit",309,317
9,1,55,1,10,"Cytron_G15Shield::setTemperatureLimit@319-329@/home/gmv/RHA/SW/lib/Cytron_G15Shield/Cytron_G15Shield.cpp","/home/gmv/RHA/SW/lib/Cytron_G15Shield/Cytron_G15Shield.cpp","Cytron_G15Shield::setTemperatureLimit",319,329
10,1,65,2,11,"Cytron_G15Shield::setVoltageLimit@331-342@/home/gmv/RHA/SW/lib/Cytron_G15Shield/Cytron_G15Shield.cpp","/home/gmv/RHA/SW/lib/Cytron_G15Shield/Cytron_G15Shield.cpp","Cytron_G15Shield::setVoltageLimit",331,342
9,1,55,1,10,"Cytron_G15Shield::setID@348-358@/home/gmv/RHA/SW/lib/Cytron_G15Shield/Cytron_G15Shield.cpp","/home/gmv/RHA/SW/lib/Cytron_G15Shield/Cytron_G15Shield.cpp","Cytron_G15Shield::setID",348,358
6,1,46,2,7,"Cytron_G15Shield::setLED@364-371@/home/gmv/RHA/SW/lib/Cytron_G15Shield/Cytron_G15Shield.cpp","/home/gmv/RHA/SW/lib/Cytron_G15Shield/Cytron_G15Shield.cpp","Cytron_G15Shield::setLED",364,371
11,1,66,1,13,"Cytron_G15Shield::setAlarmLED@373-386@/home/gmv/RHA/SW/lib/Cytron_G15Shield/Cytron_G15Shield.cpp","/home/gmv/RHA/SW/lib/Cytron_G15Shield/Cytron_G15Shield.cpp","Cytron_G15Shield::setAlarmLED",373,386
11,1,66,1,13,"Cytron_G15Shield::setAlarmShutDown@388-401@/home/gmv/RHA/SW/lib/Cytron_G15Shield/Cytron_G15Shield.cpp","/home/gmv/RHA/SW/lib/Cytron_G15Shield/Cytron_G15Shield.cpp","Cytron_G15Shield::setAlarmShutDown",388,401
18,2,137,5,23,"Cytron_G15Shield::setMarginSlopePunch@403-426@/home/gmv/RHA/SW/lib/Cytron_G15Shield/Cytron_G15Shield.cpp","/home/gmv/RHA/SW/lib/Cytron_G15Shield/Cytron_G15Shield.cpp","Cytron_G15Shield::setMarginSlopePunch",403,426
9,1,61,1,10,"Cytron_G15Shield::setBaudRate@432-442@/home/gmv/RHA/SW/lib/Cytron_G15Shield/Cytron_G15Shield.cpp","/home/gmv/RHA/SW/lib/Cytron_G15Shield/Cytron_G15Shield.cpp","Cytron_G15Shield::setBaudRate",432,442
7,1,39,0,7,"Cytron_G15Shield::factoryReset@448-455@/home/gmv/RHA/SW/lib/Cytron_G15Shield/Cytron_G15Shield.cpp","/home/gmv/RHA/SW/lib/Cytron_G15Shield/Cytron_G15Shield.cpp","Cytron_G15Shield::factoryReset",448,455
3,1,24,1,2,"Cytron_G15Shield::ping@460-462@/home/gmv/RHA/SW/lib/Cytron_G15Shield/Cytron_G15Shield.cpp","/home/gmv/RHA/SW/lib/Cytron_G15Shield/Cytron_G15Shield.cpp","Cytron_G15Shield::ping",460,462
5,1,38,1,5,"Cytron_G15Shield::getPos@467-472@/home/gmv/RHA/SW/lib/Cytron_G15Shield/Cytron_G15Shield.cpp","/home/gmv/RHA/SW/lib/Cytron_G15Shield/Cytron_G15Shield.cpp","Cytron_G15Shield::getPos",467,472
5,1,38,1,5,"Cytron_G15Shield::getSpeed@474-479@/home/gmv/RHA/SW/lib/Cytron_G15Shield/Cytron_G15Shield.cpp","/home/gmv/RHA/SW/lib/Cytron_G15Shield/Cytron_G15Shield.cpp","Cytron_G15Shield::getSpeed",474,479
5,1,38,1,5,"Cytron_G15Shield::getLoad@481-486@/home/gmv/RHA/SW/lib/Cytron_G15Shield/Cytron_G15Shield.cpp","/home/gmv/RHA/SW/lib/Cytron_G15Shield/Cytron_G15Shield.cpp","Cytron_G15Shield::getLoad",481,486
5,1,38,1,5,"Cytron_G15Shield::getVoltage@488-493@/home/gmv/RHA/SW/lib/Cytron_G15Shield/Cytron_G15Shield.cpp","/home/gmv/RHA/SW/lib/Cytron_G15Shield/Cytron_G15Shield.cpp","Cytron_G15Shield::getVoltage",488,493
5,1,38,1,5,"Cytron_G15Shield::getTemperature@495-500@/home/gmv/RHA/SW/lib/Cytron_G15Shield/Cytron_G15Shield.cpp","/home/gmv/RHA/SW/lib/Cytron_G15Shield/Cytron_G15Shield.cpp","Cytron_G15Shield::getTemperature",495,500
5,1,38,1,5,"Cytron_G15Shield::getTorqueOnOff@505-510@/home/gmv/RHA/SW/lib/Cytron_G15Shield/Cytron_G15Shield.cpp","/home/gmv/RHA/SW/lib/Cytron_G15Shield/Cytron_G15Shield.cpp","Cytron_G15Shield::getTorqueOnOff",505,510
5,1,38,1,5,"Cytron_G15Shield::isMoving@515-520@/home/gmv/RHA/SW/lib/Cytron_G15Shield/Cytron_G15Shield.cpp","/home/gmv/RHA/SW/lib/Cytron_G15Shield/Cytron_G15Shield.cpp","Cytron_G15Shield::isMoving",515,520
3,1,13,1,4,"Cytron_G15Shield::setAction@528-532@/home/gmv/RHA/SW/lib/Cytron_G15Shield/Cytron_G15Shield.cpp","/home/gmv/RHA/SW/lib/Cytron_G15Shield/Cytron_G15Shield.cpp","Cytron_G15Shield::setAction",528,532
25,4,178,1,30,"set_act@534-564@/home/gmv/RHA/SW/lib/Cytron_G15Shield/Cytron_G15Shield.cpp","/home/gmv/RHA/SW/lib/Cytron_G15Shield/Cytron_G15Shield.cpp","set_act",534,564
1,1,5,0,0,"Cytron_G15Shield::Cytron_G15Shield@143-143@/home/gmv/RHA/SW/lib/Cytron_G15Shield/Cytron_G15Shield.h","/home/gmv/RHA/SW/lib/Cytron_G15Shield/Cytron_G15Shield.h","Cytron_G15Shield::Cytron_G15Shield",143,143
5,1,25,0,5,"setup@16-21@/home/gmv/RHA/SW/src/main.cpp","/home/gmv/RHA/SW/src/main.cpp","setup",16,21
14,2,78,0,15,"loop@23-38@/home/gmv/RHA/SW/src/main.cpp","/home/gmv/RHA/SW/src/main.cpp","loop",23,38
