25,1,174,0,27,"setup@25-52@/home/quique/Documentos/RHA/SW/src/main.cpp","/home/quique/Documentos/RHA/SW/src/main.cpp","setup",25,52
2,1,5,0,2,"loop@54-56@/home/quique/Documentos/RHA/SW/src/main.cpp","/home/quique/Documentos/RHA/SW/src/main.cpp","loop",54,56
17,13,149,1,17,"printServoStatusError@23-40@/home/quique/Documentos/RHA/SW/src/utilities.h","/home/quique/Documentos/RHA/SW/src/utilities.h","printServoStatusError",23,40
65,8,402,0,75,"checkSpeed@46-121@/home/quique/Documentos/RHA/SW/src/utilities.h","/home/quique/Documentos/RHA/SW/src/utilities.h","checkSpeed",46,121
17,2,104,1,18,"checkTimeGetInfo@128-146@/home/quique/Documentos/RHA/SW/src/utilities.h","/home/quique/Documentos/RHA/SW/src/utilities.h","checkTimeGetInfo",128,146
17,2,104,1,18,"checkTimeSpeedRead@153-171@/home/quique/Documentos/RHA/SW/src/utilities.h","/home/quique/Documentos/RHA/SW/src/utilities.h","checkTimeSpeedRead",153,171
5,1,25,3,4,"initCytronG15Shield@31-35@/home/quique/Documentos/RHA/SW/lib/cytron_g15_servo/cytron_g15_servo.cpp","/home/quique/Documentos/RHA/SW/lib/cytron_g15_servo/cytron_g15_servo.cpp","initCytronG15Shield",31,35
4,1,31,4,3,"Cytron_G15_Servo::Cytron_G15_Servo@37-40@/home/quique/Documentos/RHA/SW/lib/cytron_g15_servo/cytron_g15_servo.cpp","/home/quique/Documentos/RHA/SW/lib/cytron_g15_servo/cytron_g15_servo.cpp","Cytron_G15_Servo::Cytron_G15_Servo",37,40
3,1,24,3,2,"Cytron_G15_Servo::Cytron_G15_Servo@42-44@/home/quique/Documentos/RHA/SW/lib/cytron_g15_servo/cytron_g15_servo.cpp","/home/quique/Documentos/RHA/SW/lib/cytron_g15_servo/cytron_g15_servo.cpp","Cytron_G15_Servo::Cytron_G15_Servo",42,44
3,1,18,1,2,"Cytron_G15_Servo::Cytron_G15_Servo@46-48@/home/quique/Documentos/RHA/SW/lib/cytron_g15_servo/cytron_g15_servo.cpp","/home/quique/Documentos/RHA/SW/lib/cytron_g15_servo/cytron_g15_servo.cpp","Cytron_G15_Servo::Cytron_G15_Servo",46,48
5,1,39,5,4,"Cytron_G15_Servo::init@50-54@/home/quique/Documentos/RHA/SW/lib/cytron_g15_servo/cytron_g15_servo.cpp","/home/quique/Documentos/RHA/SW/lib/cytron_g15_servo/cytron_g15_servo.cpp","Cytron_G15_Servo::init",50,54
17,4,102,1,16,"Cytron_G15_Servo::begin@56-72@/home/quique/Documentos/RHA/SW/lib/cytron_g15_servo/cytron_g15_servo.cpp","/home/quique/Documentos/RHA/SW/lib/cytron_g15_servo/cytron_g15_servo.cpp","Cytron_G15_Servo::begin",56,72
10,3,56,1,9,"Cytron_G15_Servo::end@74-83@/home/quique/Documentos/RHA/SW/lib/cytron_g15_servo/cytron_g15_servo.cpp","/home/quique/Documentos/RHA/SW/lib/cytron_g15_servo/cytron_g15_servo.cpp","Cytron_G15_Servo::end",74,83
3,1,15,1,2,"Cytron_G15_Servo::setTxMode@85-87@/home/quique/Documentos/RHA/SW/lib/cytron_g15_servo/cytron_g15_servo.cpp","/home/quique/Documentos/RHA/SW/lib/cytron_g15_servo/cytron_g15_servo.cpp","Cytron_G15_Servo::setTxMode",85,87
3,1,15,1,2,"Cytron_G15_Servo::setRxMode@89-91@/home/quique/Documentos/RHA/SW/lib/cytron_g15_servo/cytron_g15_servo.cpp","/home/quique/Documentos/RHA/SW/lib/cytron_g15_servo/cytron_g15_servo.cpp","Cytron_G15_Servo::setRxMode",89,91
78,21,528,4,90,"Cytron_G15_Servo::sendPacket@95-185@/home/quique/Documentos/RHA/SW/lib/cytron_g15_servo/cytron_g15_servo.cpp","/home/quique/Documentos/RHA/SW/lib/cytron_g15_servo/cytron_g15_servo.cpp","Cytron_G15_Servo::sendPacket",95,185
9,2,48,0,9,"Cytron_G15_Servo::setWheelMode@187-196@/home/quique/Documentos/RHA/SW/lib/cytron_g15_servo/cytron_g15_servo.cpp","/home/quique/Documentos/RHA/SW/lib/cytron_g15_servo/cytron_g15_servo.cpp","Cytron_G15_Servo::setWheelMode",187,196
3,1,17,0,2,"Cytron_G15_Servo::exitWheelMode@198-200@/home/quique/Documentos/RHA/SW/lib/cytron_g15_servo/cytron_g15_servo.cpp","/home/quique/Documentos/RHA/SW/lib/cytron_g15_servo/cytron_g15_servo.cpp","Cytron_G15_Servo::exitWheelMode",198,200
7,2,45,3,6,"Cytron_G15_Servo::setWheelSpeed@202-208@/home/quique/Documentos/RHA/SW/lib/cytron_g15_servo/cytron_g15_servo.cpp","/home/quique/Documentos/RHA/SW/lib/cytron_g15_servo/cytron_g15_servo.cpp","Cytron_G15_Servo::setWheelSpeed",202,208
7,1,58,2,8,"Cytron_G15_Servo::setPos@216-224@/home/quique/Documentos/RHA/SW/lib/cytron_g15_servo/cytron_g15_servo.cpp","/home/quique/Documentos/RHA/SW/lib/cytron_g15_servo/cytron_g15_servo.cpp","Cytron_G15_Servo::setPos",216,224
8,1,66,2,9,"Cytron_G15_Servo::setPosAngle@226-235@/home/quique/Documentos/RHA/SW/lib/cytron_g15_servo/cytron_g15_servo.cpp","/home/quique/Documentos/RHA/SW/lib/cytron_g15_servo/cytron_g15_servo.cpp","Cytron_G15_Servo::setPosAngle",226,235
9,1,80,3,10,"Cytron_G15_Servo::setPosSpeed@237-247@/home/quique/Documentos/RHA/SW/lib/cytron_g15_servo/cytron_g15_servo.cpp","/home/quique/Documentos/RHA/SW/lib/cytron_g15_servo/cytron_g15_servo.cpp","Cytron_G15_Servo::setPosSpeed",237,247
4,1,28,2,4,"Cytron_G15_Servo::rotateCW@249-253@/home/quique/Documentos/RHA/SW/lib/cytron_g15_servo/cytron_g15_servo.cpp","/home/quique/Documentos/RHA/SW/lib/cytron_g15_servo/cytron_g15_servo.cpp","Cytron_G15_Servo::rotateCW",249,253
5,1,34,2,5,"Cytron_G15_Servo::rotateCCW@255-260@/home/quique/Documentos/RHA/SW/lib/cytron_g15_servo/cytron_g15_servo.cpp","/home/quique/Documentos/RHA/SW/lib/cytron_g15_servo/cytron_g15_servo.cpp","Cytron_G15_Servo::rotateCCW",255,260
6,1,46,2,7,"Cytron_G15_Servo::setTorqueOnOff@266-273@/home/quique/Documentos/RHA/SW/lib/cytron_g15_servo/cytron_g15_servo.cpp","/home/quique/Documentos/RHA/SW/lib/cytron_g15_servo/cytron_g15_servo.cpp","Cytron_G15_Servo::setTorqueOnOff",266,273
7,1,58,2,8,"Cytron_G15_Servo::setSpeed@281-289@/home/quique/Documentos/RHA/SW/lib/cytron_g15_servo/cytron_g15_servo.cpp","/home/quique/Documentos/RHA/SW/lib/cytron_g15_servo/cytron_g15_servo.cpp","Cytron_G15_Servo::setSpeed",281,289
5,1,34,2,5,"Cytron_G15_Servo::setTimeToGoal@292-297@/home/quique/Documentos/RHA/SW/lib/cytron_g15_servo/cytron_g15_servo.cpp","/home/quique/Documentos/RHA/SW/lib/cytron_g15_servo/cytron_g15_servo.cpp","Cytron_G15_Servo::setTimeToGoal",292,297
12,1,89,2,13,"Cytron_G15_Servo::setAngleLimit@308-321@/home/quique/Documentos/RHA/SW/lib/cytron_g15_servo/cytron_g15_servo.cpp","/home/quique/Documentos/RHA/SW/lib/cytron_g15_servo/cytron_g15_servo.cpp","Cytron_G15_Servo::setAngleLimit",308,321
7,1,55,1,8,"Cytron_G15_Servo::setTorqueLimit@323-331@/home/quique/Documentos/RHA/SW/lib/cytron_g15_servo/cytron_g15_servo.cpp","/home/quique/Documentos/RHA/SW/lib/cytron_g15_servo/cytron_g15_servo.cpp","Cytron_G15_Servo::setTorqueLimit",323,331
9,1,55,1,10,"Cytron_G15_Servo::setTemperatureLimit@333-343@/home/quique/Documentos/RHA/SW/lib/cytron_g15_servo/cytron_g15_servo.cpp","/home/quique/Documentos/RHA/SW/lib/cytron_g15_servo/cytron_g15_servo.cpp","Cytron_G15_Servo::setTemperatureLimit",333,343
10,1,65,2,11,"Cytron_G15_Servo::setVoltageLimit@345-356@/home/quique/Documentos/RHA/SW/lib/cytron_g15_servo/cytron_g15_servo.cpp","/home/quique/Documentos/RHA/SW/lib/cytron_g15_servo/cytron_g15_servo.cpp","Cytron_G15_Servo::setVoltageLimit",345,356
9,1,55,1,10,"Cytron_G15_Servo::setID@362-372@/home/quique/Documentos/RHA/SW/lib/cytron_g15_servo/cytron_g15_servo.cpp","/home/quique/Documentos/RHA/SW/lib/cytron_g15_servo/cytron_g15_servo.cpp","Cytron_G15_Servo::setID",362,372
6,1,46,2,7,"Cytron_G15_Servo::setLED@378-385@/home/quique/Documentos/RHA/SW/lib/cytron_g15_servo/cytron_g15_servo.cpp","/home/quique/Documentos/RHA/SW/lib/cytron_g15_servo/cytron_g15_servo.cpp","Cytron_G15_Servo::setLED",378,385
11,1,66,1,13,"Cytron_G15_Servo::setAlarmLED@387-400@/home/quique/Documentos/RHA/SW/lib/cytron_g15_servo/cytron_g15_servo.cpp","/home/quique/Documentos/RHA/SW/lib/cytron_g15_servo/cytron_g15_servo.cpp","Cytron_G15_Servo::setAlarmLED",387,400
11,1,66,1,13,"Cytron_G15_Servo::setAlarmShutDown@402-415@/home/quique/Documentos/RHA/SW/lib/cytron_g15_servo/cytron_g15_servo.cpp","/home/quique/Documentos/RHA/SW/lib/cytron_g15_servo/cytron_g15_servo.cpp","Cytron_G15_Servo::setAlarmShutDown",402,415
18,2,137,5,23,"Cytron_G15_Servo::setMarginSlopePunch@417-440@/home/quique/Documentos/RHA/SW/lib/cytron_g15_servo/cytron_g15_servo.cpp","/home/quique/Documentos/RHA/SW/lib/cytron_g15_servo/cytron_g15_servo.cpp","Cytron_G15_Servo::setMarginSlopePunch",417,440
9,1,61,1,10,"Cytron_G15_Servo::setBaudRate@446-456@/home/quique/Documentos/RHA/SW/lib/cytron_g15_servo/cytron_g15_servo.cpp","/home/quique/Documentos/RHA/SW/lib/cytron_g15_servo/cytron_g15_servo.cpp","Cytron_G15_Servo::setBaudRate",446,456
7,1,39,0,7,"Cytron_G15_Servo::factoryReset@462-469@/home/quique/Documentos/RHA/SW/lib/cytron_g15_servo/cytron_g15_servo.cpp","/home/quique/Documentos/RHA/SW/lib/cytron_g15_servo/cytron_g15_servo.cpp","Cytron_G15_Servo::factoryReset",462,469
3,1,24,1,2,"Cytron_G15_Servo::ping@474-476@/home/quique/Documentos/RHA/SW/lib/cytron_g15_servo/cytron_g15_servo.cpp","/home/quique/Documentos/RHA/SW/lib/cytron_g15_servo/cytron_g15_servo.cpp","Cytron_G15_Servo::ping",474,476
5,1,38,1,5,"Cytron_G15_Servo::getPos@481-486@/home/quique/Documentos/RHA/SW/lib/cytron_g15_servo/cytron_g15_servo.cpp","/home/quique/Documentos/RHA/SW/lib/cytron_g15_servo/cytron_g15_servo.cpp","Cytron_G15_Servo::getPos",481,486
5,1,38,1,5,"Cytron_G15_Servo::getSpeed@488-493@/home/quique/Documentos/RHA/SW/lib/cytron_g15_servo/cytron_g15_servo.cpp","/home/quique/Documentos/RHA/SW/lib/cytron_g15_servo/cytron_g15_servo.cpp","Cytron_G15_Servo::getSpeed",488,493
5,1,38,1,5,"Cytron_G15_Servo::getLoad@495-500@/home/quique/Documentos/RHA/SW/lib/cytron_g15_servo/cytron_g15_servo.cpp","/home/quique/Documentos/RHA/SW/lib/cytron_g15_servo/cytron_g15_servo.cpp","Cytron_G15_Servo::getLoad",495,500
5,1,38,1,5,"Cytron_G15_Servo::getVoltage@502-507@/home/quique/Documentos/RHA/SW/lib/cytron_g15_servo/cytron_g15_servo.cpp","/home/quique/Documentos/RHA/SW/lib/cytron_g15_servo/cytron_g15_servo.cpp","Cytron_G15_Servo::getVoltage",502,507
5,1,38,1,5,"Cytron_G15_Servo::getTemperature@509-514@/home/quique/Documentos/RHA/SW/lib/cytron_g15_servo/cytron_g15_servo.cpp","/home/quique/Documentos/RHA/SW/lib/cytron_g15_servo/cytron_g15_servo.cpp","Cytron_G15_Servo::getTemperature",509,514
5,1,38,1,5,"Cytron_G15_Servo::getTorqueOnOff@519-524@/home/quique/Documentos/RHA/SW/lib/cytron_g15_servo/cytron_g15_servo.cpp","/home/quique/Documentos/RHA/SW/lib/cytron_g15_servo/cytron_g15_servo.cpp","Cytron_G15_Servo::getTorqueOnOff",519,524
5,1,38,1,5,"Cytron_G15_Servo::isMoving@529-534@/home/quique/Documentos/RHA/SW/lib/cytron_g15_servo/cytron_g15_servo.cpp","/home/quique/Documentos/RHA/SW/lib/cytron_g15_servo/cytron_g15_servo.cpp","Cytron_G15_Servo::isMoving",529,534
3,1,13,1,4,"Cytron_G15_Servo::setAction@542-546@/home/quique/Documentos/RHA/SW/lib/cytron_g15_servo/cytron_g15_servo.cpp","/home/quique/Documentos/RHA/SW/lib/cytron_g15_servo/cytron_g15_servo.cpp","Cytron_G15_Servo::setAction",542,546
25,4,178,1,30,"set_act@548-578@/home/quique/Documentos/RHA/SW/lib/cytron_g15_servo/cytron_g15_servo.cpp","/home/quique/Documentos/RHA/SW/lib/cytron_g15_servo/cytron_g15_servo.cpp","set_act",548,578
1,1,5,0,0,"Cytron_G15_Servo::Cytron_G15_Servo@164-164@/home/quique/Documentos/RHA/SW/lib/cytron_g15_servo/cytron_g15_servo.h","/home/quique/Documentos/RHA/SW/lib/cytron_g15_servo/cytron_g15_servo.h","Cytron_G15_Servo::Cytron_G15_Servo",164,164
3,1,13,1,2,"JointHandler::JointHandler@19-21@/home/quique/Documentos/RHA/SW/lib/joint_handler/joint_handler.cpp","/home/quique/Documentos/RHA/SW/lib/joint_handler/joint_handler.cpp","JointHandler::JointHandler",19,21
4,1,24,1,3,"JointHandler::init@26-29@/home/quique/Documentos/RHA/SW/lib/joint_handler/joint_handler.cpp","/home/quique/Documentos/RHA/SW/lib/joint_handler/joint_handler.cpp","JointHandler::init",26,29
16,2,137,0,24,"JointHandler::controlLoop@34-58@/home/quique/Documentos/RHA/SW/lib/joint_handler/joint_handler.cpp","/home/quique/Documentos/RHA/SW/lib/joint_handler/joint_handler.cpp","JointHandler::controlLoop",34,58
5,1,31,3,4,"JointRHA::JointRHA@19-23@/home/quique/Documentos/RHA/SW/lib/joint_rha/joint_rha.cpp","/home/quique/Documentos/RHA/SW/lib/joint_rha/joint_rha.cpp","JointRHA::JointRHA",19,23
2,1,7,0,1,"JointRHA::~JointRHA@27-28@/home/quique/Documentos/RHA/SW/lib/joint_rha/joint_rha.cpp","/home/quique/Documentos/RHA/SW/lib/joint_rha/joint_rha.cpp","JointRHA::~JointRHA",27,28
6,1,45,3,7,"JointRHA::init@35-42@/home/quique/Documentos/RHA/SW/lib/joint_rha/joint_rha.cpp","/home/quique/Documentos/RHA/SW/lib/joint_rha/joint_rha.cpp","JointRHA::init",35,42
6,1,33,3,5,"JointRHA::setGoal@50-55@/home/quique/Documentos/RHA/SW/lib/joint_rha/joint_rha.cpp","/home/quique/Documentos/RHA/SW/lib/joint_rha/joint_rha.cpp","JointRHA::setGoal",50,55
6,2,53,0,5,"JointRHA::speedError@61-66@/home/quique/Documentos/RHA/SW/lib/joint_rha/joint_rha.cpp","/home/quique/Documentos/RHA/SW/lib/joint_rha/joint_rha.cpp","JointRHA::speedError",61,66
3,1,17,1,2,"JointRHA::regulatorJoint@73-75@/home/quique/Documentos/RHA/SW/lib/joint_rha/joint_rha.cpp","/home/quique/Documentos/RHA/SW/lib/joint_rha/joint_rha.cpp","JointRHA::regulatorJoint",73,75
3,1,40,5,2,"ServoRHA::addToPacket@87-89@/home/quique/Documentos/RHA/SW/lib/joint_rha/joint_rha.cpp","/home/quique/Documentos/RHA/SW/lib/joint_rha/joint_rha.cpp","ServoRHA::addToPacket",87,89
3,1,39,5,2,"JointRHA::wrapPacket@100-102@/home/quique/Documentos/RHA/SW/lib/joint_rha/joint_rha.cpp","/home/quique/Documentos/RHA/SW/lib/joint_rha/joint_rha.cpp","JointRHA::wrapPacket",100,102
3,1,32,3,2,"sendPacket@104-106@/home/quique/Documentos/RHA/SW/lib/joint_rha/joint_rha.cpp","/home/quique/Documentos/RHA/SW/lib/joint_rha/joint_rha.cpp","sendPacket",104,106
4,1,20,0,3,"JointRHA::updateInfo@111-114@/home/quique/Documentos/RHA/SW/lib/joint_rha/joint_rha.cpp","/home/quique/Documentos/RHA/SW/lib/joint_rha/joint_rha.cpp","JointRHA::updateInfo",111,114
1,1,5,0,0,"ServoRHA::ServoRHA@62-62@/home/quique/Documentos/RHA/SW/lib/servo_rha/servo_rha.h","/home/quique/Documentos/RHA/SW/lib/servo_rha/servo_rha.h","ServoRHA::ServoRHA",62,62
1,1,8,0,0,"ServoRHA::getID@81-81@/home/quique/Documentos/RHA/SW/lib/servo_rha/servo_rha.h","/home/quique/Documentos/RHA/SW/lib/servo_rha/servo_rha.h","ServoRHA::getID",81,81
1,1,8,0,0,"ServoRHA::getSpeed@82-82@/home/quique/Documentos/RHA/SW/lib/servo_rha/servo_rha.h","/home/quique/Documentos/RHA/SW/lib/servo_rha/servo_rha.h","ServoRHA::getSpeed",82,82
1,1,8,0,0,"ServoRHA::getSpeedDir@83-83@/home/quique/Documentos/RHA/SW/lib/servo_rha/servo_rha.h","/home/quique/Documentos/RHA/SW/lib/servo_rha/servo_rha.h","ServoRHA::getSpeedDir",83,83
1,1,8,0,0,"ServoRHA::getPosition@84-84@/home/quique/Documentos/RHA/SW/lib/servo_rha/servo_rha.h","/home/quique/Documentos/RHA/SW/lib/servo_rha/servo_rha.h","ServoRHA::getPosition",84,84
1,1,8,0,0,"ServoRHA::getLoad@85-85@/home/quique/Documentos/RHA/SW/lib/servo_rha/servo_rha.h","/home/quique/Documentos/RHA/SW/lib/servo_rha/servo_rha.h","ServoRHA::getLoad",85,85
1,1,8,0,0,"ServoRHA::getLoadDir@86-86@/home/quique/Documentos/RHA/SW/lib/servo_rha/servo_rha.h","/home/quique/Documentos/RHA/SW/lib/servo_rha/servo_rha.h","ServoRHA::getLoadDir",86,86
1,1,8,0,0,"ServoRHA::getError@87-87@/home/quique/Documentos/RHA/SW/lib/servo_rha/servo_rha.h","/home/quique/Documentos/RHA/SW/lib/servo_rha/servo_rha.h","ServoRHA::getError",87,87
1,1,8,0,0,"ServoRHA::getVoltage@88-88@/home/quique/Documentos/RHA/SW/lib/servo_rha/servo_rha.h","/home/quique/Documentos/RHA/SW/lib/servo_rha/servo_rha.h","ServoRHA::getVoltage",88,88
1,1,8,0,0,"ServoRHA::getTemperature@89-89@/home/quique/Documentos/RHA/SW/lib/servo_rha/servo_rha.h","/home/quique/Documentos/RHA/SW/lib/servo_rha/servo_rha.h","ServoRHA::getTemperature",89,89
1,1,8,0,0,"ServoRHA::getRegistered@90-90@/home/quique/Documentos/RHA/SW/lib/servo_rha/servo_rha.h","/home/quique/Documentos/RHA/SW/lib/servo_rha/servo_rha.h","ServoRHA::getRegistered",90,90
1,1,8,0,0,"ServoRHA::getIsMoving@91-91@/home/quique/Documentos/RHA/SW/lib/servo_rha/servo_rha.h","/home/quique/Documentos/RHA/SW/lib/servo_rha/servo_rha.h","ServoRHA::getIsMoving",91,91
7,1,45,4,7,"ServoRHA::ServoRHA@26-33@/home/quique/Documentos/RHA/SW/lib/servo_rha/servo_rha.cpp","/home/quique/Documentos/RHA/SW/lib/servo_rha/servo_rha.cpp","ServoRHA::ServoRHA",26,33
9,1,64,5,12,"ServoRHA::init@43-55@/home/quique/Documentos/RHA/SW/lib/servo_rha/servo_rha.cpp","/home/quique/Documentos/RHA/SW/lib/servo_rha/servo_rha.cpp","ServoRHA::init",43,55
9,1,42,0,13,"ServoRHA::init@61-74@/home/quique/Documentos/RHA/SW/lib/servo_rha/servo_rha.cpp","/home/quique/Documentos/RHA/SW/lib/servo_rha/servo_rha.cpp","ServoRHA::init",61,74
10,1,64,0,9,"ServoRHA::angleRead@83-92@/home/quique/Documentos/RHA/SW/lib/servo_rha/servo_rha.cpp","/home/quique/Documentos/RHA/SW/lib/servo_rha/servo_rha.cpp","ServoRHA::angleRead",83,92
10,1,60,0,9,"ServoRHA::speedRead@97-106@/home/quique/Documentos/RHA/SW/lib/servo_rha/servo_rha.cpp","/home/quique/Documentos/RHA/SW/lib/servo_rha/servo_rha.cpp","ServoRHA::speedRead",97,106
7,2,37,0,6,"ServoRHA::isMoving@111-117@/home/quique/Documentos/RHA/SW/lib/servo_rha/servo_rha.cpp","/home/quique/Documentos/RHA/SW/lib/servo_rha/servo_rha.cpp","ServoRHA::isMoving",111,117
20,1,163,0,28,"ServoRHA::updateInfo@130-158@/home/quique/Documentos/RHA/SW/lib/servo_rha/servo_rha.cpp","/home/quique/Documentos/RHA/SW/lib/servo_rha/servo_rha.cpp","ServoRHA::updateInfo",130,158
3,1,12,1,2,"regulatorServo@164-166@/home/quique/Documentos/RHA/SW/lib/servo_rha/servo_rha.cpp","/home/quique/Documentos/RHA/SW/lib/servo_rha/servo_rha.cpp","regulatorServo",164,166
8,1,53,1,10,"ServoRHA::returnPacketSet@177-187@/home/quique/Documentos/RHA/SW/lib/servo_rha/servo_rha.cpp","/home/quique/Documentos/RHA/SW/lib/servo_rha/servo_rha.cpp","ServoRHA::returnPacketSet",177,187
11,2,77,5,10,"ServoRHA::addToPacket@196-206@/home/quique/Documentos/RHA/SW/lib/servo_rha/servo_rha.cpp","/home/quique/Documentos/RHA/SW/lib/servo_rha/servo_rha.cpp","ServoRHA::addToPacket",196,206
19,2,182,5,19,"ServoRHA::wrapPacket@216-235@/home/quique/Documentos/RHA/SW/lib/servo_rha/servo_rha.cpp","/home/quique/Documentos/RHA/SW/lib/servo_rha/servo_rha.cpp","ServoRHA::wrapPacket",216,235
8,1,45,0,7,"ServoRHA::calibrateTorque@245-252@/home/quique/Documentos/RHA/SW/lib/servo_rha/servo_rha.cpp","/home/quique/Documentos/RHA/SW/lib/servo_rha/servo_rha.cpp","ServoRHA::calibrateTorque",245,252
13,3,87,2,15,"ServoRHA::calibrateTorqueDir@258-273@/home/quique/Documentos/RHA/SW/lib/servo_rha/servo_rha.cpp","/home/quique/Documentos/RHA/SW/lib/servo_rha/servo_rha.cpp","ServoRHA::calibrateTorqueDir",258,273
10,6,134,2,11,"ServoRHA::setWheelSpeed@287-298@/home/quique/Documentos/RHA/SW/lib/servo_rha/servo_rha.cpp","/home/quique/Documentos/RHA/SW/lib/servo_rha/servo_rha.cpp","ServoRHA::setWheelSpeed",287,298
6,3,51,3,5,"compareAngles@311-316@/home/quique/Documentos/RHA/SW/lib/servo_rha/servo_rha.cpp","/home/quique/Documentos/RHA/SW/lib/servo_rha/servo_rha.cpp","compareAngles",311,316
6,3,51,3,5,"compareSpeed@324-329@/home/quique/Documentos/RHA/SW/lib/servo_rha/servo_rha.cpp","/home/quique/Documentos/RHA/SW/lib/servo_rha/servo_rha.cpp","compareSpeed",324,329
