12,1,94,0,13,"setup@29-42@/home/quique/Documentos/RHA/SW/src/main.cpp","/home/quique/Documentos/RHA/SW/src/main.cpp","setup",29,42
11,2,72,0,13,"loop@44-57@/home/quique/Documentos/RHA/SW/src/main.cpp","/home/quique/Documentos/RHA/SW/src/main.cpp","loop",44,57
1,1,36,4,0,"RHATypes::SpeedGoal::SpeedGoal@29-29@/home/quique/Documentos/RHA/SW/lib/rha_types/rha_types.h","/home/quique/Documentos/RHA/SW/lib/rha_types/rha_types.h","RHATypes::SpeedGoal::SpeedGoal",29,29
4,2,30,0,3,"RHATypes::Regulator::Regulator@45-48@/home/quique/Documentos/RHA/SW/lib/rha_types/rha_types.h","/home/quique/Documentos/RHA/SW/lib/rha_types/rha_types.h","RHATypes::Regulator::Regulator",45,48
4,2,36,0,3,"RHATypes::Regulator::resetRegulator@54-57@/home/quique/Documentos/RHA/SW/lib/rha_types/rha_types.h","/home/quique/Documentos/RHA/SW/lib/rha_types/rha_types.h","RHATypes::Regulator::resetRegulator",54,57
3,1,29,3,2,"RHATypes::Regulator::setKRegulator@66-68@/home/quique/Documentos/RHA/SW/lib/rha_types/rha_types.h","/home/quique/Documentos/RHA/SW/lib/rha_types/rha_types.h","RHATypes::Regulator::setKRegulator",66,68
8,3,76,3,8,"RHATypes::Regulator::regulator@78-86@/home/quique/Documentos/RHA/SW/lib/rha_types/rha_types.h","/home/quique/Documentos/RHA/SW/lib/rha_types/rha_types.h","RHATypes::Regulator::regulator",78,86
1,1,8,0,0,"RHATypes::Regulator::getKp@88-88@/home/quique/Documentos/RHA/SW/lib/rha_types/rha_types.h","/home/quique/Documentos/RHA/SW/lib/rha_types/rha_types.h","RHATypes::Regulator::getKp",88,88
1,1,8,0,0,"RHATypes::Regulator::getKi@89-89@/home/quique/Documentos/RHA/SW/lib/rha_types/rha_types.h","/home/quique/Documentos/RHA/SW/lib/rha_types/rha_types.h","RHATypes::Regulator::getKi",89,89
1,1,8,0,0,"RHATypes::Regulator::getKd@90-90@/home/quique/Documentos/RHA/SW/lib/rha_types/rha_types.h","/home/quique/Documentos/RHA/SW/lib/rha_types/rha_types.h","RHATypes::Regulator::getKd",90,90
3,1,11,1,2,"RHATypes::Timer::setTimer@103-105@/home/quique/Documentos/RHA/SW/lib/rha_types/rha_types.h","/home/quique/Documentos/RHA/SW/lib/rha_types/rha_types.h","RHATypes::Timer::setTimer",103,105
4,1,16,0,3,"RHATypes::Timer::activateTimer@111-114@/home/quique/Documentos/RHA/SW/lib/rha_types/rha_types.h","/home/quique/Documentos/RHA/SW/lib/rha_types/rha_types.h","RHATypes::Timer::activateTimer",111,114
6,2,37,0,5,"RHATypes::Timer::checkWait@120-125@/home/quique/Documentos/RHA/SW/lib/rha_types/rha_types.h","/home/quique/Documentos/RHA/SW/lib/rha_types/rha_types.h","RHATypes::Timer::checkWait",120,125
5,2,37,0,4,"RHATypes::Timer::checkContinue@132-136@/home/quique/Documentos/RHA/SW/lib/rha_types/rha_types.h","/home/quique/Documentos/RHA/SW/lib/rha_types/rha_types.h","RHATypes::Timer::checkContinue",132,136
1,1,8,0,0,"RHATypes::Timer::getInitTime@143-143@/home/quique/Documentos/RHA/SW/lib/rha_types/rha_types.h","/home/quique/Documentos/RHA/SW/lib/rha_types/rha_types.h","RHATypes::Timer::getInitTime",143,143
4,1,16,0,3,"RHATypes::TimerMicroseconds::activateTimer@157-160@/home/quique/Documentos/RHA/SW/lib/rha_types/rha_types.h","/home/quique/Documentos/RHA/SW/lib/rha_types/rha_types.h","RHATypes::TimerMicroseconds::activateTimer",157,160
6,2,37,0,5,"RHATypes::TimerMicroseconds::checkWait@166-171@/home/quique/Documentos/RHA/SW/lib/rha_types/rha_types.h","/home/quique/Documentos/RHA/SW/lib/rha_types/rha_types.h","RHATypes::TimerMicroseconds::checkWait",166,171
5,2,37,0,4,"RHATypes::TimerMicroseconds::checkContinue@177-181@/home/quique/Documentos/RHA/SW/lib/rha_types/rha_types.h","/home/quique/Documentos/RHA/SW/lib/rha_types/rha_types.h","RHATypes::TimerMicroseconds::checkContinue",177,181
3,1,16,1,2,"JointHandler::JointHandler@23-25@/home/quique/Documentos/RHA/SW/lib/joint_handler/joint_handler.cpp","/home/quique/Documentos/RHA/SW/lib/joint_handler/joint_handler.cpp","JointHandler::JointHandler",23,25
5,1,27,1,4,"JointHandler::setTimer@32-36@/home/quique/Documentos/RHA/SW/lib/joint_handler/joint_handler.cpp","/home/quique/Documentos/RHA/SW/lib/joint_handler/joint_handler.cpp","JointHandler::setTimer",32,36
6,1,44,0,6,"JointHandler::initJoints@42-48@/home/quique/Documentos/RHA/SW/lib/joint_handler/joint_handler.cpp","/home/quique/Documentos/RHA/SW/lib/joint_handler/joint_handler.cpp","JointHandler::initJoints",42,48
12,2,55,0,19,"JointHandler::controlLoop@53-72@/home/quique/Documentos/RHA/SW/lib/joint_handler/joint_handler.cpp","/home/quique/Documentos/RHA/SW/lib/joint_handler/joint_handler.cpp","JointHandler::controlLoop",53,72
12,2,99,0,12,"JointHandler::updateJointInfo@79-91@/home/quique/Documentos/RHA/SW/lib/joint_handler/joint_handler.cpp","/home/quique/Documentos/RHA/SW/lib/joint_handler/joint_handler.cpp","JointHandler::updateJointInfo",79,91
7,2,50,0,6,"JointHandler::updateJointErrorTorque@97-103@/home/quique/Documentos/RHA/SW/lib/joint_handler/joint_handler.cpp","/home/quique/Documentos/RHA/SW/lib/joint_handler/joint_handler.cpp","JointHandler::updateJointErrorTorque",97,103
15,3,106,0,14,"JointHandler::sendJointTorques@109-123@/home/quique/Documentos/RHA/SW/lib/joint_handler/joint_handler.cpp","/home/quique/Documentos/RHA/SW/lib/joint_handler/joint_handler.cpp","JointHandler::sendJointTorques",109,123
6,3,48,1,6,"JointHandler::setSpeedGoal@130-136@/home/quique/Documentos/RHA/SW/lib/joint_handler/joint_handler.cpp","/home/quique/Documentos/RHA/SW/lib/joint_handler/joint_handler.cpp","JointHandler::setSpeedGoal",130,136
25,3,194,0,28,"JointHandler::sendSetWheelModeAll@142-170@/home/quique/Documentos/RHA/SW/lib/joint_handler/joint_handler.cpp","/home/quique/Documentos/RHA/SW/lib/joint_handler/joint_handler.cpp","JointHandler::sendSetWheelModeAll",142,170
11,2,85,0,10,"JointHandler::sendExitWheelModeAll@176-186@/home/quique/Documentos/RHA/SW/lib/joint_handler/joint_handler.cpp","/home/quique/Documentos/RHA/SW/lib/joint_handler/joint_handler.cpp","JointHandler::sendExitWheelModeAll",176,186
11,2,89,1,10,"JointHandler::sendSetTorqueLimitAll@194-204@/home/quique/Documentos/RHA/SW/lib/joint_handler/joint_handler.cpp","/home/quique/Documentos/RHA/SW/lib/joint_handler/joint_handler.cpp","JointHandler::sendSetTorqueLimitAll",194,204
11,2,112,2,10,"JointHandler::sendSetWheelSpeedAll@213-223@/home/quique/Documentos/RHA/SW/lib/joint_handler/joint_handler.cpp","/home/quique/Documentos/RHA/SW/lib/joint_handler/joint_handler.cpp","JointHandler::sendSetWheelSpeedAll",213,223
13,3,97,0,12,"JointHandler::checkConectionAll@231-243@/home/quique/Documentos/RHA/SW/lib/joint_handler/joint_handler.cpp","/home/quique/Documentos/RHA/SW/lib/joint_handler/joint_handler.cpp","JointHandler::checkConectionAll",231,243
8,2,74,3,7,"JointHandler::addToSyncPacket@258-265@/home/quique/Documentos/RHA/SW/lib/joint_handler/joint_handler.cpp","/home/quique/Documentos/RHA/SW/lib/joint_handler/joint_handler.cpp","JointHandler::addToSyncPacket",258,265
17,2,173,5,19,"JointHandler::warpSyncPacket@278-297@/home/quique/Documentos/RHA/SW/lib/joint_handler/joint_handler.cpp","/home/quique/Documentos/RHA/SW/lib/joint_handler/joint_handler.cpp","JointHandler::warpSyncPacket",278,297
15,2,144,3,17,"JointHandler::warpSinglePacket@307-324@/home/quique/Documentos/RHA/SW/lib/joint_handler/joint_handler.cpp","/home/quique/Documentos/RHA/SW/lib/joint_handler/joint_handler.cpp","JointHandler::warpSinglePacket",307,324
71,20,454,1,97,"JointHandler::sendPacket@332-429@/home/quique/Documentos/RHA/SW/lib/joint_handler/joint_handler.cpp","/home/quique/Documentos/RHA/SW/lib/joint_handler/joint_handler.cpp","JointHandler::sendPacket",332,429
5,1,27,3,4,"JointHandler::JointHandler@443-447@/home/quique/Documentos/RHA/SW/lib/joint_handler/joint_handler.cpp","/home/quique/Documentos/RHA/SW/lib/joint_handler/joint_handler.cpp","JointHandler::JointHandler",443,447
5,1,21,1,4,"JointHandler::JointHandler@454-458@/home/quique/Documentos/RHA/SW/lib/joint_handler/joint_handler.cpp","/home/quique/Documentos/RHA/SW/lib/joint_handler/joint_handler.cpp","JointHandler::JointHandler",454,458
7,1,40,4,6,"JointHandler::initSerial@469-475@/home/quique/Documentos/RHA/SW/lib/joint_handler/joint_handler.cpp","/home/quique/Documentos/RHA/SW/lib/joint_handler/joint_handler.cpp","JointHandler::initSerial",469,475
18,5,120,1,17,"JointHandler::begin@482-499@/home/quique/Documentos/RHA/SW/lib/joint_handler/joint_handler.cpp","/home/quique/Documentos/RHA/SW/lib/joint_handler/joint_handler.cpp","JointHandler::begin",482,499
10,4,65,1,9,"JointHandler::end@501-510@/home/quique/Documentos/RHA/SW/lib/joint_handler/joint_handler.cpp","/home/quique/Documentos/RHA/SW/lib/joint_handler/joint_handler.cpp","JointHandler::end",501,510
3,1,15,1,2,"JointHandler::setTxMode@512-514@/home/quique/Documentos/RHA/SW/lib/joint_handler/joint_handler.cpp","/home/quique/Documentos/RHA/SW/lib/joint_handler/joint_handler.cpp","JointHandler::setTxMode",512,514
3,1,15,1,2,"JointHandler::setRxMode@516-518@/home/quique/Documentos/RHA/SW/lib/joint_handler/joint_handler.cpp","/home/quique/Documentos/RHA/SW/lib/joint_handler/joint_handler.cpp","JointHandler::setRxMode",516,518
1,1,5,0,0,"JointHandler::JointHandler@82-82@/home/quique/Documentos/RHA/SW/lib/joint_handler/joint_handler.h","/home/quique/Documentos/RHA/SW/lib/joint_handler/joint_handler.h","JointHandler::JointHandler",82,82
1,1,5,0,0,"JointRHA::JointRHA@33-33@/home/quique/Documentos/RHA/SW/lib/joint_rha/joint_rha.h","/home/quique/Documentos/RHA/SW/lib/joint_rha/joint_rha.h","JointRHA::JointRHA",33,33
5,1,30,3,5,"JointRHA::JointRHA@19-24@/home/quique/Documentos/RHA/SW/lib/joint_rha/joint_rha.cpp","/home/quique/Documentos/RHA/SW/lib/joint_rha/joint_rha.cpp","JointRHA::JointRHA",19,24
2,1,7,0,1,"JointRHA::~JointRHA@28-29@/home/quique/Documentos/RHA/SW/lib/joint_rha/joint_rha.cpp","/home/quique/Documentos/RHA/SW/lib/joint_rha/joint_rha.cpp","JointRHA::~JointRHA",28,29
8,1,49,3,9,"JointRHA::init@36-45@/home/quique/Documentos/RHA/SW/lib/joint_rha/joint_rha.cpp","/home/quique/Documentos/RHA/SW/lib/joint_rha/joint_rha.cpp","JointRHA::init",36,45
3,1,14,0,2,"JointRHA::updateInfo@50-52@/home/quique/Documentos/RHA/SW/lib/joint_rha/joint_rha.cpp","/home/quique/Documentos/RHA/SW/lib/joint_rha/joint_rha.cpp","JointRHA::updateInfo",50,52
2,1,29,0,1,"ServoRHA::ServoRHA@143-144@/home/quique/Documentos/RHA/SW/lib/servo_rha/servo_rha.h","/home/quique/Documentos/RHA/SW/lib/servo_rha/servo_rha.h","ServoRHA::ServoRHA",143,144
1,1,8,0,0,"ServoRHA::getID@175-175@/home/quique/Documentos/RHA/SW/lib/servo_rha/servo_rha.h","/home/quique/Documentos/RHA/SW/lib/servo_rha/servo_rha.h","ServoRHA::getID",175,175
1,1,8,0,0,"ServoRHA::getSpeed@176-176@/home/quique/Documentos/RHA/SW/lib/servo_rha/servo_rha.h","/home/quique/Documentos/RHA/SW/lib/servo_rha/servo_rha.h","ServoRHA::getSpeed",176,176
1,1,8,0,0,"ServoRHA::getSpeedDir@177-177@/home/quique/Documentos/RHA/SW/lib/servo_rha/servo_rha.h","/home/quique/Documentos/RHA/SW/lib/servo_rha/servo_rha.h","ServoRHA::getSpeedDir",177,177
1,1,8,0,0,"ServoRHA::getPosition@178-178@/home/quique/Documentos/RHA/SW/lib/servo_rha/servo_rha.h","/home/quique/Documentos/RHA/SW/lib/servo_rha/servo_rha.h","ServoRHA::getPosition",178,178
1,1,8,0,0,"ServoRHA::getLoad@179-179@/home/quique/Documentos/RHA/SW/lib/servo_rha/servo_rha.h","/home/quique/Documentos/RHA/SW/lib/servo_rha/servo_rha.h","ServoRHA::getLoad",179,179
1,1,8,0,0,"ServoRHA::getLoadDir@180-180@/home/quique/Documentos/RHA/SW/lib/servo_rha/servo_rha.h","/home/quique/Documentos/RHA/SW/lib/servo_rha/servo_rha.h","ServoRHA::getLoadDir",180,180
1,1,8,0,0,"ServoRHA::getCommError@181-181@/home/quique/Documentos/RHA/SW/lib/servo_rha/servo_rha.h","/home/quique/Documentos/RHA/SW/lib/servo_rha/servo_rha.h","ServoRHA::getCommError",181,181
1,1,8,0,0,"ServoRHA::getVoltage@182-182@/home/quique/Documentos/RHA/SW/lib/servo_rha/servo_rha.h","/home/quique/Documentos/RHA/SW/lib/servo_rha/servo_rha.h","ServoRHA::getVoltage",182,182
1,1,8,0,0,"ServoRHA::getTemperature@183-183@/home/quique/Documentos/RHA/SW/lib/servo_rha/servo_rha.h","/home/quique/Documentos/RHA/SW/lib/servo_rha/servo_rha.h","ServoRHA::getTemperature",183,183
1,1,8,0,0,"ServoRHA::getGoalTorque@184-184@/home/quique/Documentos/RHA/SW/lib/servo_rha/servo_rha.h","/home/quique/Documentos/RHA/SW/lib/servo_rha/servo_rha.h","ServoRHA::getGoalTorque",184,184
1,1,8,0,0,"ServoRHA::getSpeedTarget@185-185@/home/quique/Documentos/RHA/SW/lib/servo_rha/servo_rha.h","/home/quique/Documentos/RHA/SW/lib/servo_rha/servo_rha.h","ServoRHA::getSpeedTarget",185,185
1,1,8,0,0,"ServoRHA::getSpeedSlope@186-186@/home/quique/Documentos/RHA/SW/lib/servo_rha/servo_rha.h","/home/quique/Documentos/RHA/SW/lib/servo_rha/servo_rha.h","ServoRHA::getSpeedSlope",186,186
1,1,8,0,0,"ServoRHA::getDirectionTarget@187-187@/home/quique/Documentos/RHA/SW/lib/servo_rha/servo_rha.h","/home/quique/Documentos/RHA/SW/lib/servo_rha/servo_rha.h","ServoRHA::getDirectionTarget",187,187
1,1,8,0,0,"ServoRHA::getError@188-188@/home/quique/Documentos/RHA/SW/lib/servo_rha/servo_rha.h","/home/quique/Documentos/RHA/SW/lib/servo_rha/servo_rha.h","ServoRHA::getError",188,188
1,1,8,0,0,"ServoRHA::getDError@189-189@/home/quique/Documentos/RHA/SW/lib/servo_rha/servo_rha.h","/home/quique/Documentos/RHA/SW/lib/servo_rha/servo_rha.h","ServoRHA::getDError",189,189
1,1,8,0,0,"ServoRHA::getIError@190-190@/home/quique/Documentos/RHA/SW/lib/servo_rha/servo_rha.h","/home/quique/Documentos/RHA/SW/lib/servo_rha/servo_rha.h","ServoRHA::getIError",190,190
3,1,13,1,2,"ServoRHA::ServoRHA@22-24@/home/quique/Documentos/RHA/SW/lib/servo_rha/servo_rha.cpp","/home/quique/Documentos/RHA/SW/lib/servo_rha/servo_rha.cpp","ServoRHA::ServoRHA",22,24
7,1,41,1,10,"ServoRHA::init@30-40@/home/quique/Documentos/RHA/SW/lib/servo_rha/servo_rha.cpp","/home/quique/Documentos/RHA/SW/lib/servo_rha/servo_rha.cpp","ServoRHA::init",30,40
18,1,155,2,26,"ServoRHA::updateInfo@60-86@/home/quique/Documentos/RHA/SW/lib/servo_rha/servo_rha.cpp","/home/quique/Documentos/RHA/SW/lib/servo_rha/servo_rha.cpp","ServoRHA::updateInfo",60,86
14,2,91,1,13,"ServoRHA::setSpeedGoal@95-108@/home/quique/Documentos/RHA/SW/lib/servo_rha/servo_rha.cpp","/home/quique/Documentos/RHA/SW/lib/servo_rha/servo_rha.cpp","ServoRHA::setSpeedGoal",95,108
11,2,88,0,15,"ServoRHA::speedError@113-128@/home/quique/Documentos/RHA/SW/lib/servo_rha/servo_rha.cpp","/home/quique/Documentos/RHA/SW/lib/servo_rha/servo_rha.cpp","ServoRHA::speedError",113,128
10,3,71,0,17,"ServoRHA::calculateTorque@137-154@/home/quique/Documentos/RHA/SW/lib/servo_rha/servo_rha.cpp","/home/quique/Documentos/RHA/SW/lib/servo_rha/servo_rha.cpp","ServoRHA::calculateTorque",137,154
6,1,41,1,5,"ServoRHA::addUpadteInfoToPacket@166-171@/home/quique/Documentos/RHA/SW/lib/servo_rha/servo_rha.cpp","/home/quique/Documentos/RHA/SW/lib/servo_rha/servo_rha.cpp","ServoRHA::addUpadteInfoToPacket",166,171
9,1,56,2,11,"ServoRHA::addReturnOptionToPacket@179-190@/home/quique/Documentos/RHA/SW/lib/servo_rha/servo_rha.cpp","/home/quique/Documentos/RHA/SW/lib/servo_rha/servo_rha.cpp","ServoRHA::addReturnOptionToPacket",179,190
14,2,86,1,15,"ServoRHA::addTorqueToPacket@197-212@/home/quique/Documentos/RHA/SW/lib/servo_rha/servo_rha.cpp","/home/quique/Documentos/RHA/SW/lib/servo_rha/servo_rha.cpp","ServoRHA::addTorqueToPacket",197,212
6,1,44,2,6,"ServoRHA::setTorqueOnOfToPacket@220-226@/home/quique/Documentos/RHA/SW/lib/servo_rha/servo_rha.cpp","/home/quique/Documentos/RHA/SW/lib/servo_rha/servo_rha.cpp","ServoRHA::setTorqueOnOfToPacket",220,226
3,1,19,1,3,"ServoRHA::setWheelModeToPacket@235-238@/home/quique/Documentos/RHA/SW/lib/servo_rha/servo_rha.cpp","/home/quique/Documentos/RHA/SW/lib/servo_rha/servo_rha.cpp","ServoRHA::setWheelModeToPacket",235,238
3,1,19,1,2,"ServoRHA::exitWheelModeToPacket@247-249@/home/quique/Documentos/RHA/SW/lib/servo_rha/servo_rha.cpp","/home/quique/Documentos/RHA/SW/lib/servo_rha/servo_rha.cpp","ServoRHA::exitWheelModeToPacket",247,249
9,1,78,3,10,"ServoRHA::wheelModeToPacket@259-269@/home/quique/Documentos/RHA/SW/lib/servo_rha/servo_rha.cpp","/home/quique/Documentos/RHA/SW/lib/servo_rha/servo_rha.cpp","ServoRHA::wheelModeToPacket",259,269
4,1,29,1,3,"ServoRHA::pingToPacket@276-279@/home/quique/Documentos/RHA/SW/lib/servo_rha/servo_rha.cpp","/home/quique/Documentos/RHA/SW/lib/servo_rha/servo_rha.cpp","ServoRHA::pingToPacket",276,279
7,1,56,2,8,"ServoRHA::setTorqueLimitToPacket@287-295@/home/quique/Documentos/RHA/SW/lib/servo_rha/servo_rha.cpp","/home/quique/Documentos/RHA/SW/lib/servo_rha/servo_rha.cpp","ServoRHA::setTorqueLimitToPacket",287,295
11,2,79,3,12,"ServoRHA::setWheelSpeedToPacket@304-316@/home/quique/Documentos/RHA/SW/lib/servo_rha/servo_rha.cpp","/home/quique/Documentos/RHA/SW/lib/servo_rha/servo_rha.cpp","ServoRHA::setWheelSpeedToPacket",304,316
9,2,69,3,10,"ServoRHA::addToPacket@324-334@/home/quique/Documentos/RHA/SW/lib/servo_rha/servo_rha.cpp","/home/quique/Documentos/RHA/SW/lib/servo_rha/servo_rha.cpp","ServoRHA::addToPacket",324,334
6,3,57,3,5,"compareAngles@347-352@/home/quique/Documentos/RHA/SW/lib/servo_rha/servo_rha.cpp","/home/quique/Documentos/RHA/SW/lib/servo_rha/servo_rha.cpp","compareAngles",347,352
6,3,57,3,5,"compareSpeed@360-365@/home/quique/Documentos/RHA/SW/lib/servo_rha/servo_rha.cpp","/home/quique/Documentos/RHA/SW/lib/servo_rha/servo_rha.cpp","compareSpeed",360,365
19,6,181,4,24,"MeasureUtilities::averageChauvenet@40-64@/home/quique/Documentos/RHA/SW/lib/utilities/utilities.cpp","/home/quique/Documentos/RHA/SW/lib/utilities/utilities.cpp","MeasureUtilities::averageChauvenet",40,64
20,3,137,1,24,"JHUtilitiesJH::initJoints@72-96@/home/quique/Documentos/RHA/SW/lib/utilities/utilities.cpp","/home/quique/Documentos/RHA/SW/lib/utilities/utilities.cpp","JHUtilitiesJH::initJoints",72,96
34,4,495,1,43,"JHUtilitiesJH::extractRegulatorData@103-146@/home/quique/Documentos/RHA/SW/lib/utilities/utilities.cpp","/home/quique/Documentos/RHA/SW/lib/utilities/utilities.cpp","JHUtilitiesJH::extractRegulatorData",103,146
21,3,224,1,36,"JHUtilitiesJH::extractStepInputData@149-185@/home/quique/Documentos/RHA/SW/lib/utilities/utilities.cpp","/home/quique/Documentos/RHA/SW/lib/utilities/utilities.cpp","JHUtilitiesJH::extractStepInputData",149,185
25,4,258,1,27,"JHUtilitiesJH::extractSlopeInputData@188-215@/home/quique/Documentos/RHA/SW/lib/utilities/utilities.cpp","/home/quique/Documentos/RHA/SW/lib/utilities/utilities.cpp","JHUtilitiesJH::extractSlopeInputData",188,215
23,3,172,2,24,"JHUtilitiesJH::checkTimeGetInfo@223-247@/home/quique/Documentos/RHA/SW/lib/utilities/utilities.cpp","/home/quique/Documentos/RHA/SW/lib/utilities/utilities.cpp","JHUtilitiesJH::checkTimeGetInfo",223,247
13,3,75,1,14,"JHUtilitiesJH::checkComSucces@254-268@/home/quique/Documentos/RHA/SW/lib/utilities/utilities.cpp","/home/quique/Documentos/RHA/SW/lib/utilities/utilities.cpp","JHUtilitiesJH::checkComSucces",254,268
56,8,383,1,68,"JHUtilitiesJH::checkSpeed@274-342@/home/quique/Documentos/RHA/SW/lib/utilities/utilities.cpp","/home/quique/Documentos/RHA/SW/lib/utilities/utilities.cpp","JHUtilitiesJH::checkSpeed",274,342
3,1,9,0,2,"JHUtilitiesJH::JHUtilitiesJH@82-84@/home/quique/Documentos/RHA/SW/lib/utilities/utilities.h","/home/quique/Documentos/RHA/SW/lib/utilities/utilities.h","JHUtilitiesJH::JHUtilitiesJH",82,84
17,15,219,2,17,"printServoStatusError@14-31@/home/quique/Documentos/RHA/SW/lib/debug/debug.cpp","/home/quique/Documentos/RHA/SW/lib/debug/debug.cpp","printServoStatusError",14,31
13,1,161,8,12,"printServoStatus@33-45@/home/quique/Documentos/RHA/SW/lib/debug/debug.cpp","/home/quique/Documentos/RHA/SW/lib/debug/debug.cpp","printServoStatus",33,45
