14,1,90,0,17,"setup@28-45@/home/quique/Documentos/RHA/SW/src/main_utilities.cpp","/home/quique/Documentos/RHA/SW/src/main_utilities.cpp","setup",28,45
7,2,34,0,45,"loop@53-98@/home/quique/Documentos/RHA/SW/src/main_utilities.cpp","/home/quique/Documentos/RHA/SW/src/main_utilities.cpp","loop",53,98
5,2,38,0,4,"RHATypes::Regulator::Regulator@32-36@/home/quique/Documentos/RHA/SW/lib/rha_types/pid_regulator.h","/home/quique/Documentos/RHA/SW/lib/rha_types/pid_regulator.h","RHATypes::Regulator::Regulator",32,36
4,2,36,0,3,"RHATypes::Regulator::resetRegulator@42-45@/home/quique/Documentos/RHA/SW/lib/rha_types/pid_regulator.h","/home/quique/Documentos/RHA/SW/lib/rha_types/pid_regulator.h","RHATypes::Regulator::resetRegulator",42,45
3,1,29,3,2,"RHATypes::Regulator::setKRegulator@54-56@/home/quique/Documentos/RHA/SW/lib/rha_types/pid_regulator.h","/home/quique/Documentos/RHA/SW/lib/rha_types/pid_regulator.h","RHATypes::Regulator::setKRegulator",54,56
8,3,78,3,8,"RHATypes::Regulator::regulator@66-74@/home/quique/Documentos/RHA/SW/lib/rha_types/pid_regulator.h","/home/quique/Documentos/RHA/SW/lib/rha_types/pid_regulator.h","RHATypes::Regulator::regulator",66,74
1,1,8,0,0,"RHATypes::Regulator::getKp@76-76@/home/quique/Documentos/RHA/SW/lib/rha_types/pid_regulator.h","/home/quique/Documentos/RHA/SW/lib/rha_types/pid_regulator.h","RHATypes::Regulator::getKp",76,76
1,1,8,0,0,"RHATypes::Regulator::getKi@77-77@/home/quique/Documentos/RHA/SW/lib/rha_types/pid_regulator.h","/home/quique/Documentos/RHA/SW/lib/rha_types/pid_regulator.h","RHATypes::Regulator::getKi",77,77
1,1,8,0,0,"RHATypes::Regulator::getKd@78-78@/home/quique/Documentos/RHA/SW/lib/rha_types/pid_regulator.h","/home/quique/Documentos/RHA/SW/lib/rha_types/pid_regulator.h","RHATypes::Regulator::getKd",78,78
3,1,13,0,2,"RHATypes::FuzzyRegulatorNode::FuzzyRegulatorNode@28-30@/home/quique/Documentos/RHA/SW/lib/rha_types/fuzzy_regulator.h","/home/quique/Documentos/RHA/SW/lib/rha_types/fuzzy_regulator.h","RHATypes::FuzzyRegulatorNode::FuzzyRegulatorNode",28,30
4,1,15,0,3,"RHATypes::FuzzyRegulatorNode::resetRegulator@36-39@/home/quique/Documentos/RHA/SW/lib/rha_types/fuzzy_regulator.h","/home/quique/Documentos/RHA/SW/lib/rha_types/fuzzy_regulator.h","RHATypes::FuzzyRegulatorNode::resetRegulator",36,39
4,1,35,4,3,"RHATypes::FuzzyRegulatorNode::setRegulator@49-52@/home/quique/Documentos/RHA/SW/lib/rha_types/fuzzy_regulator.h","/home/quique/Documentos/RHA/SW/lib/rha_types/fuzzy_regulator.h","RHATypes::FuzzyRegulatorNode::setRegulator",49,52
3,1,29,3,2,"RHATypes::FuzzyRegulatorNode::regulator@54-56@/home/quique/Documentos/RHA/SW/lib/rha_types/fuzzy_regulator.h","/home/quique/Documentos/RHA/SW/lib/rha_types/fuzzy_regulator.h","RHATypes::FuzzyRegulatorNode::regulator",54,56
1,1,8,0,0,"RHATypes::FuzzyRegulatorNode::getAplicationPoint@58-58@/home/quique/Documentos/RHA/SW/lib/rha_types/fuzzy_regulator.h","/home/quique/Documentos/RHA/SW/lib/rha_types/fuzzy_regulator.h","RHATypes::FuzzyRegulatorNode::getAplicationPoint",58,58
12,1,165,0,12,"RHATypes::FuzzyRegulator::FuzzyRegulator@65-77@/home/quique/Documentos/RHA/SW/lib/rha_types/fuzzy_regulator.h","/home/quique/Documentos/RHA/SW/lib/rha_types/fuzzy_regulator.h","RHATypes::FuzzyRegulator::FuzzyRegulator",65,77
16,4,144,4,19,"RHATypes::FuzzyRegulator::regulator@88-107@/home/quique/Documentos/RHA/SW/lib/rha_types/fuzzy_regulator.h","/home/quique/Documentos/RHA/SW/lib/rha_types/fuzzy_regulator.h","RHATypes::FuzzyRegulator::regulator",88,107
1,1,36,4,0,"RHATypes::SpeedGoal::SpeedGoal@33-33@/home/quique/Documentos/RHA/SW/lib/rha_types/rha_types.h","/home/quique/Documentos/RHA/SW/lib/rha_types/rha_types.h","RHATypes::SpeedGoal::SpeedGoal",33,33
3,1,11,1,2,"RHATypes::Timer::setTimer@47-49@/home/quique/Documentos/RHA/SW/lib/rha_types/rha_types.h","/home/quique/Documentos/RHA/SW/lib/rha_types/rha_types.h","RHATypes::Timer::setTimer",47,49
4,1,16,0,3,"RHATypes::Timer::activateTimer@55-58@/home/quique/Documentos/RHA/SW/lib/rha_types/rha_types.h","/home/quique/Documentos/RHA/SW/lib/rha_types/rha_types.h","RHATypes::Timer::activateTimer",55,58
6,2,37,0,5,"RHATypes::Timer::checkWait@64-69@/home/quique/Documentos/RHA/SW/lib/rha_types/rha_types.h","/home/quique/Documentos/RHA/SW/lib/rha_types/rha_types.h","RHATypes::Timer::checkWait",64,69
5,2,37,0,4,"RHATypes::Timer::checkContinue@76-80@/home/quique/Documentos/RHA/SW/lib/rha_types/rha_types.h","/home/quique/Documentos/RHA/SW/lib/rha_types/rha_types.h","RHATypes::Timer::checkContinue",76,80
1,1,8,0,0,"RHATypes::Timer::getInitTime@87-87@/home/quique/Documentos/RHA/SW/lib/rha_types/rha_types.h","/home/quique/Documentos/RHA/SW/lib/rha_types/rha_types.h","RHATypes::Timer::getInitTime",87,87
4,1,16,0,3,"RHATypes::TimerMicroseconds::activateTimer@101-104@/home/quique/Documentos/RHA/SW/lib/rha_types/rha_types.h","/home/quique/Documentos/RHA/SW/lib/rha_types/rha_types.h","RHATypes::TimerMicroseconds::activateTimer",101,104
6,2,37,0,5,"RHATypes::TimerMicroseconds::checkWait@110-115@/home/quique/Documentos/RHA/SW/lib/rha_types/rha_types.h","/home/quique/Documentos/RHA/SW/lib/rha_types/rha_types.h","RHATypes::TimerMicroseconds::checkWait",110,115
5,2,37,0,4,"RHATypes::TimerMicroseconds::checkContinue@121-125@/home/quique/Documentos/RHA/SW/lib/rha_types/rha_types.h","/home/quique/Documentos/RHA/SW/lib/rha_types/rha_types.h","RHATypes::TimerMicroseconds::checkContinue",121,125
3,1,16,1,2,"JointHandler::JointHandler@23-25@/home/quique/Documentos/RHA/SW/lib/joint_handler/joint_handler.cpp","/home/quique/Documentos/RHA/SW/lib/joint_handler/joint_handler.cpp","JointHandler::JointHandler",23,25
5,1,27,1,4,"JointHandler::setTimer@32-36@/home/quique/Documentos/RHA/SW/lib/joint_handler/joint_handler.cpp","/home/quique/Documentos/RHA/SW/lib/joint_handler/joint_handler.cpp","JointHandler::setTimer",32,36
12,1,71,0,18,"JointHandler::initJoints@42-60@/home/quique/Documentos/RHA/SW/lib/joint_handler/joint_handler.cpp","/home/quique/Documentos/RHA/SW/lib/joint_handler/joint_handler.cpp","JointHandler::initJoints",42,60
12,2,55,0,19,"JointHandler::controlLoop@65-84@/home/quique/Documentos/RHA/SW/lib/joint_handler/joint_handler.cpp","/home/quique/Documentos/RHA/SW/lib/joint_handler/joint_handler.cpp","JointHandler::controlLoop",65,84
12,2,97,0,12,"JointHandler::updateJointInfo@91-103@/home/quique/Documentos/RHA/SW/lib/joint_handler/joint_handler.cpp","/home/quique/Documentos/RHA/SW/lib/joint_handler/joint_handler.cpp","JointHandler::updateJointInfo",91,103
7,2,50,0,6,"JointHandler::updateJointErrorTorque@109-115@/home/quique/Documentos/RHA/SW/lib/joint_handler/joint_handler.cpp","/home/quique/Documentos/RHA/SW/lib/joint_handler/joint_handler.cpp","JointHandler::updateJointErrorTorque",109,115
15,3,106,0,14,"JointHandler::sendJointTorques@121-135@/home/quique/Documentos/RHA/SW/lib/joint_handler/joint_handler.cpp","/home/quique/Documentos/RHA/SW/lib/joint_handler/joint_handler.cpp","JointHandler::sendJointTorques",121,135
6,3,48,1,6,"JointHandler::setSpeedGoal@142-148@/home/quique/Documentos/RHA/SW/lib/joint_handler/joint_handler.cpp","/home/quique/Documentos/RHA/SW/lib/joint_handler/joint_handler.cpp","JointHandler::setSpeedGoal",142,148
11,2,89,1,10,"JointHandler::setReturnPacketOption@150-160@/home/quique/Documentos/RHA/SW/lib/joint_handler/joint_handler.cpp","/home/quique/Documentos/RHA/SW/lib/joint_handler/joint_handler.cpp","JointHandler::setReturnPacketOption",150,160
25,3,194,0,28,"JointHandler::sendSetWheelModeAll@166-194@/home/quique/Documentos/RHA/SW/lib/joint_handler/joint_handler.cpp","/home/quique/Documentos/RHA/SW/lib/joint_handler/joint_handler.cpp","JointHandler::sendSetWheelModeAll",166,194
18,2,126,0,26,"JointHandler::sendExitWheelModeAll@200-226@/home/quique/Documentos/RHA/SW/lib/joint_handler/joint_handler.cpp","/home/quique/Documentos/RHA/SW/lib/joint_handler/joint_handler.cpp","JointHandler::sendExitWheelModeAll",200,226
11,2,89,1,10,"JointHandler::sendSetTorqueLimitAll@234-244@/home/quique/Documentos/RHA/SW/lib/joint_handler/joint_handler.cpp","/home/quique/Documentos/RHA/SW/lib/joint_handler/joint_handler.cpp","JointHandler::sendSetTorqueLimitAll",234,244
18,3,153,2,17,"JointHandler::sendSetWheelSpeedAll@253-270@/home/quique/Documentos/RHA/SW/lib/joint_handler/joint_handler.cpp","/home/quique/Documentos/RHA/SW/lib/joint_handler/joint_handler.cpp","JointHandler::sendSetWheelSpeedAll",253,270
13,3,97,0,12,"JointHandler::checkConectionAll@278-290@/home/quique/Documentos/RHA/SW/lib/joint_handler/joint_handler.cpp","/home/quique/Documentos/RHA/SW/lib/joint_handler/joint_handler.cpp","JointHandler::checkConectionAll",278,290
8,2,74,3,7,"JointHandler::addToSyncPacket@305-312@/home/quique/Documentos/RHA/SW/lib/joint_handler/joint_handler.cpp","/home/quique/Documentos/RHA/SW/lib/joint_handler/joint_handler.cpp","JointHandler::addToSyncPacket",305,312
17,2,173,5,19,"JointHandler::warpSyncPacket@325-344@/home/quique/Documentos/RHA/SW/lib/joint_handler/joint_handler.cpp","/home/quique/Documentos/RHA/SW/lib/joint_handler/joint_handler.cpp","JointHandler::warpSyncPacket",325,344
15,2,144,3,17,"JointHandler::warpSinglePacket@354-371@/home/quique/Documentos/RHA/SW/lib/joint_handler/joint_handler.cpp","/home/quique/Documentos/RHA/SW/lib/joint_handler/joint_handler.cpp","JointHandler::warpSinglePacket",354,371
71,20,454,1,97,"JointHandler::sendPacket@379-476@/home/quique/Documentos/RHA/SW/lib/joint_handler/joint_handler.cpp","/home/quique/Documentos/RHA/SW/lib/joint_handler/joint_handler.cpp","JointHandler::sendPacket",379,476
5,1,27,3,4,"JointHandler::JointHandler@490-494@/home/quique/Documentos/RHA/SW/lib/joint_handler/joint_handler.cpp","/home/quique/Documentos/RHA/SW/lib/joint_handler/joint_handler.cpp","JointHandler::JointHandler",490,494
5,1,21,1,4,"JointHandler::JointHandler@501-505@/home/quique/Documentos/RHA/SW/lib/joint_handler/joint_handler.cpp","/home/quique/Documentos/RHA/SW/lib/joint_handler/joint_handler.cpp","JointHandler::JointHandler",501,505
7,1,40,4,6,"JointHandler::initSerial@516-522@/home/quique/Documentos/RHA/SW/lib/joint_handler/joint_handler.cpp","/home/quique/Documentos/RHA/SW/lib/joint_handler/joint_handler.cpp","JointHandler::initSerial",516,522
18,5,120,1,17,"JointHandler::begin@529-546@/home/quique/Documentos/RHA/SW/lib/joint_handler/joint_handler.cpp","/home/quique/Documentos/RHA/SW/lib/joint_handler/joint_handler.cpp","JointHandler::begin",529,546
10,4,65,1,9,"JointHandler::end@548-557@/home/quique/Documentos/RHA/SW/lib/joint_handler/joint_handler.cpp","/home/quique/Documentos/RHA/SW/lib/joint_handler/joint_handler.cpp","JointHandler::end",548,557
3,1,15,1,2,"JointHandler::setTxMode@559-561@/home/quique/Documentos/RHA/SW/lib/joint_handler/joint_handler.cpp","/home/quique/Documentos/RHA/SW/lib/joint_handler/joint_handler.cpp","JointHandler::setTxMode",559,561
3,1,15,1,2,"JointHandler::setRxMode@563-565@/home/quique/Documentos/RHA/SW/lib/joint_handler/joint_handler.cpp","/home/quique/Documentos/RHA/SW/lib/joint_handler/joint_handler.cpp","JointHandler::setRxMode",563,565
1,1,5,0,0,"JointHandler::JointHandler@84-84@/home/quique/Documentos/RHA/SW/lib/joint_handler/joint_handler.h","/home/quique/Documentos/RHA/SW/lib/joint_handler/joint_handler.h","JointHandler::JointHandler",84,84
5,1,33,0,4,"RobotRHA::initJointHandler@7-11@/home/quique/Documentos/RHA/SW/lib/robot_rha/robot_rha.cpp","/home/quique/Documentos/RHA/SW/lib/robot_rha/robot_rha.cpp","RobotRHA::initJointHandler",7,11
4,1,20,0,3,"RobotRHA::initChuckHandler@17-20@/home/quique/Documentos/RHA/SW/lib/robot_rha/robot_rha.cpp","/home/quique/Documentos/RHA/SW/lib/robot_rha/robot_rha.cpp","RobotRHA::initChuckHandler",17,20
2,1,7,0,2,"RobotRHA::handleRobot@22-24@/home/quique/Documentos/RHA/SW/lib/robot_rha/robot_rha.cpp","/home/quique/Documentos/RHA/SW/lib/robot_rha/robot_rha.cpp","RobotRHA::handleRobot",22,24
9,1,62,3,8,"RobotRHA::setCartesianSpeedGoal@33-41@/home/quique/Documentos/RHA/SW/lib/robot_rha/robot_rha.cpp","/home/quique/Documentos/RHA/SW/lib/robot_rha/robot_rha.cpp","RobotRHA::setCartesianSpeedGoal",33,41
6,2,54,2,5,"RobotRHA::setSpeedToServos@49-54@/home/quique/Documentos/RHA/SW/lib/robot_rha/robot_rha.cpp","/home/quique/Documentos/RHA/SW/lib/robot_rha/robot_rha.cpp","RobotRHA::setSpeedToServos",49,54
15,2,108,0,16,"RobotRHA::handleWithChuck@60-76@/home/quique/Documentos/RHA/SW/lib/robot_rha/robot_rha.cpp","/home/quique/Documentos/RHA/SW/lib/robot_rha/robot_rha.cpp","RobotRHA::handleWithChuck",60,76
1,1,5,0,0,"JointRHA::JointRHA@35-35@/home/quique/Documentos/RHA/SW/lib/joint_rha/joint_rha.h","/home/quique/Documentos/RHA/SW/lib/joint_rha/joint_rha.h","JointRHA::JointRHA",35,35
5,1,30,3,5,"JointRHA::JointRHA@19-24@/home/quique/Documentos/RHA/SW/lib/joint_rha/joint_rha.cpp","/home/quique/Documentos/RHA/SW/lib/joint_rha/joint_rha.cpp","JointRHA::JointRHA",19,24
2,1,7,0,1,"JointRHA::~JointRHA@28-29@/home/quique/Documentos/RHA/SW/lib/joint_rha/joint_rha.cpp","/home/quique/Documentos/RHA/SW/lib/joint_rha/joint_rha.cpp","JointRHA::~JointRHA",28,29
8,2,55,3,8,"JointRHA::init@36-44@/home/quique/Documentos/RHA/SW/lib/joint_rha/joint_rha.cpp","/home/quique/Documentos/RHA/SW/lib/joint_rha/joint_rha.cpp","JointRHA::init",36,44
3,1,24,0,2,"JointRHA::updatePosition@51-53@/home/quique/Documentos/RHA/SW/lib/joint_rha/joint_rha.cpp","/home/quique/Documentos/RHA/SW/lib/joint_rha/joint_rha.cpp","JointRHA::updatePosition",51,53
4,1,28,2,3,"JointRHA::updateInfo@61-64@/home/quique/Documentos/RHA/SW/lib/joint_rha/joint_rha.cpp","/home/quique/Documentos/RHA/SW/lib/joint_rha/joint_rha.cpp","JointRHA::updateInfo",61,64
2,1,29,0,1,"ServoRHA::ServoRHA@147-148@/home/quique/Documentos/RHA/SW/lib/servo_rha/servo_rha.h","/home/quique/Documentos/RHA/SW/lib/servo_rha/servo_rha.h","ServoRHA::ServoRHA",147,148
1,1,8,0,0,"ServoRHA::getID@179-179@/home/quique/Documentos/RHA/SW/lib/servo_rha/servo_rha.h","/home/quique/Documentos/RHA/SW/lib/servo_rha/servo_rha.h","ServoRHA::getID",179,179
1,1,8,0,0,"ServoRHA::getSpeed@180-180@/home/quique/Documentos/RHA/SW/lib/servo_rha/servo_rha.h","/home/quique/Documentos/RHA/SW/lib/servo_rha/servo_rha.h","ServoRHA::getSpeed",180,180
1,1,8,0,0,"ServoRHA::getSpeedDir@181-181@/home/quique/Documentos/RHA/SW/lib/servo_rha/servo_rha.h","/home/quique/Documentos/RHA/SW/lib/servo_rha/servo_rha.h","ServoRHA::getSpeedDir",181,181
1,1,8,0,0,"ServoRHA::getPosition@182-182@/home/quique/Documentos/RHA/SW/lib/servo_rha/servo_rha.h","/home/quique/Documentos/RHA/SW/lib/servo_rha/servo_rha.h","ServoRHA::getPosition",182,182
1,1,8,0,0,"ServoRHA::getLoad@183-183@/home/quique/Documentos/RHA/SW/lib/servo_rha/servo_rha.h","/home/quique/Documentos/RHA/SW/lib/servo_rha/servo_rha.h","ServoRHA::getLoad",183,183
1,1,8,0,0,"ServoRHA::getLoadDir@184-184@/home/quique/Documentos/RHA/SW/lib/servo_rha/servo_rha.h","/home/quique/Documentos/RHA/SW/lib/servo_rha/servo_rha.h","ServoRHA::getLoadDir",184,184
1,1,8,0,0,"ServoRHA::getCommError@185-185@/home/quique/Documentos/RHA/SW/lib/servo_rha/servo_rha.h","/home/quique/Documentos/RHA/SW/lib/servo_rha/servo_rha.h","ServoRHA::getCommError",185,185
1,1,8,0,0,"ServoRHA::getVoltage@186-186@/home/quique/Documentos/RHA/SW/lib/servo_rha/servo_rha.h","/home/quique/Documentos/RHA/SW/lib/servo_rha/servo_rha.h","ServoRHA::getVoltage",186,186
1,1,8,0,0,"ServoRHA::getTemperature@187-187@/home/quique/Documentos/RHA/SW/lib/servo_rha/servo_rha.h","/home/quique/Documentos/RHA/SW/lib/servo_rha/servo_rha.h","ServoRHA::getTemperature",187,187
1,1,8,0,0,"ServoRHA::getGoalTorque@188-188@/home/quique/Documentos/RHA/SW/lib/servo_rha/servo_rha.h","/home/quique/Documentos/RHA/SW/lib/servo_rha/servo_rha.h","ServoRHA::getGoalTorque",188,188
1,1,8,0,0,"ServoRHA::getSpeedTarget@189-189@/home/quique/Documentos/RHA/SW/lib/servo_rha/servo_rha.h","/home/quique/Documentos/RHA/SW/lib/servo_rha/servo_rha.h","ServoRHA::getSpeedTarget",189,189
1,1,8,0,0,"ServoRHA::getSpeedSlope@190-190@/home/quique/Documentos/RHA/SW/lib/servo_rha/servo_rha.h","/home/quique/Documentos/RHA/SW/lib/servo_rha/servo_rha.h","ServoRHA::getSpeedSlope",190,190
1,1,8,0,0,"ServoRHA::getDirectionTarget@191-191@/home/quique/Documentos/RHA/SW/lib/servo_rha/servo_rha.h","/home/quique/Documentos/RHA/SW/lib/servo_rha/servo_rha.h","ServoRHA::getDirectionTarget",191,191
1,1,8,0,0,"ServoRHA::getError@192-192@/home/quique/Documentos/RHA/SW/lib/servo_rha/servo_rha.h","/home/quique/Documentos/RHA/SW/lib/servo_rha/servo_rha.h","ServoRHA::getError",192,192
1,1,8,0,0,"ServoRHA::getDError@193-193@/home/quique/Documentos/RHA/SW/lib/servo_rha/servo_rha.h","/home/quique/Documentos/RHA/SW/lib/servo_rha/servo_rha.h","ServoRHA::getDError",193,193
1,1,8,0,0,"ServoRHA::getIError@194-194@/home/quique/Documentos/RHA/SW/lib/servo_rha/servo_rha.h","/home/quique/Documentos/RHA/SW/lib/servo_rha/servo_rha.h","ServoRHA::getIError",194,194
3,1,13,1,2,"ServoRHA::ServoRHA@22-24@/home/quique/Documentos/RHA/SW/lib/servo_rha/servo_rha.cpp","/home/quique/Documentos/RHA/SW/lib/servo_rha/servo_rha.cpp","ServoRHA::ServoRHA",22,24
7,1,41,1,10,"ServoRHA::init@30-40@/home/quique/Documentos/RHA/SW/lib/servo_rha/servo_rha.cpp","/home/quique/Documentos/RHA/SW/lib/servo_rha/servo_rha.cpp","ServoRHA::init",30,40
14,1,121,2,29,"ServoRHA::updateInfo@60-89@/home/quique/Documentos/RHA/SW/lib/servo_rha/servo_rha.cpp","/home/quique/Documentos/RHA/SW/lib/servo_rha/servo_rha.cpp","ServoRHA::updateInfo",60,89
14,2,91,1,13,"ServoRHA::setSpeedGoal@98-111@/home/quique/Documentos/RHA/SW/lib/servo_rha/servo_rha.cpp","/home/quique/Documentos/RHA/SW/lib/servo_rha/servo_rha.cpp","ServoRHA::setSpeedGoal",98,111
13,1,96,0,18,"ServoRHA::speedError@116-134@/home/quique/Documentos/RHA/SW/lib/servo_rha/servo_rha.cpp","/home/quique/Documentos/RHA/SW/lib/servo_rha/servo_rha.cpp","ServoRHA::speedError",116,134
12,5,108,3,23,"ServoRHA::calculateTorque@143-166@/home/quique/Documentos/RHA/SW/lib/servo_rha/servo_rha.cpp","/home/quique/Documentos/RHA/SW/lib/servo_rha/servo_rha.cpp","ServoRHA::calculateTorque",143,166
6,1,41,1,5,"ServoRHA::addUpadteInfoToPacket@178-183@/home/quique/Documentos/RHA/SW/lib/servo_rha/servo_rha.cpp","/home/quique/Documentos/RHA/SW/lib/servo_rha/servo_rha.cpp","ServoRHA::addUpadteInfoToPacket",178,183
9,1,56,2,11,"ServoRHA::addReturnOptionToPacket@191-202@/home/quique/Documentos/RHA/SW/lib/servo_rha/servo_rha.cpp","/home/quique/Documentos/RHA/SW/lib/servo_rha/servo_rha.cpp","ServoRHA::addReturnOptionToPacket",191,202
14,2,86,1,15,"ServoRHA::addTorqueToPacket@209-224@/home/quique/Documentos/RHA/SW/lib/servo_rha/servo_rha.cpp","/home/quique/Documentos/RHA/SW/lib/servo_rha/servo_rha.cpp","ServoRHA::addTorqueToPacket",209,224
7,1,49,2,7,"ServoRHA::setTorqueOnOfToPacket@232-239@/home/quique/Documentos/RHA/SW/lib/servo_rha/servo_rha.cpp","/home/quique/Documentos/RHA/SW/lib/servo_rha/servo_rha.cpp","ServoRHA::setTorqueOnOfToPacket",232,239
4,1,24,1,4,"ServoRHA::setWheelModeToPacket@248-252@/home/quique/Documentos/RHA/SW/lib/servo_rha/servo_rha.cpp","/home/quique/Documentos/RHA/SW/lib/servo_rha/servo_rha.cpp","ServoRHA::setWheelModeToPacket",248,252
4,1,24,1,3,"ServoRHA::exitWheelModeToPacket@261-264@/home/quique/Documentos/RHA/SW/lib/servo_rha/servo_rha.cpp","/home/quique/Documentos/RHA/SW/lib/servo_rha/servo_rha.cpp","ServoRHA::exitWheelModeToPacket",261,264
9,1,78,3,10,"ServoRHA::wheelModeToPacket@274-284@/home/quique/Documentos/RHA/SW/lib/servo_rha/servo_rha.cpp","/home/quique/Documentos/RHA/SW/lib/servo_rha/servo_rha.cpp","ServoRHA::wheelModeToPacket",274,284
4,1,29,1,3,"ServoRHA::pingToPacket@291-294@/home/quique/Documentos/RHA/SW/lib/servo_rha/servo_rha.cpp","/home/quique/Documentos/RHA/SW/lib/servo_rha/servo_rha.cpp","ServoRHA::pingToPacket",291,294
8,1,61,2,9,"ServoRHA::setTorqueLimitToPacket@302-311@/home/quique/Documentos/RHA/SW/lib/servo_rha/servo_rha.cpp","/home/quique/Documentos/RHA/SW/lib/servo_rha/servo_rha.cpp","ServoRHA::setTorqueLimitToPacket",302,311
13,2,91,3,14,"ServoRHA::setWheelSpeedToPacket@320-334@/home/quique/Documentos/RHA/SW/lib/servo_rha/servo_rha.cpp","/home/quique/Documentos/RHA/SW/lib/servo_rha/servo_rha.cpp","ServoRHA::setWheelSpeedToPacket",320,334
9,2,69,3,10,"ServoRHA::addToPacket@342-352@/home/quique/Documentos/RHA/SW/lib/servo_rha/servo_rha.cpp","/home/quique/Documentos/RHA/SW/lib/servo_rha/servo_rha.cpp","ServoRHA::addToPacket",342,352
6,3,57,3,5,"compareAngles@365-370@/home/quique/Documentos/RHA/SW/lib/servo_rha/servo_rha.cpp","/home/quique/Documentos/RHA/SW/lib/servo_rha/servo_rha.cpp","compareAngles",365,370
6,3,57,3,5,"compareSpeed@378-383@/home/quique/Documentos/RHA/SW/lib/servo_rha/servo_rha.cpp","/home/quique/Documentos/RHA/SW/lib/servo_rha/servo_rha.cpp","compareSpeed",378,383
19,6,181,4,24,"MeasureUtilities::averageChauvenet@39-63@/home/quique/Documentos/RHA/SW/lib/utilities/utilities.cpp","/home/quique/Documentos/RHA/SW/lib/utilities/utilities.cpp","MeasureUtilities::averageChauvenet",39,63
15,3,108,1,24,"JHUtilitiesJH::initJoints@71-95@/home/quique/Documentos/RHA/SW/lib/utilities/utilities.cpp","/home/quique/Documentos/RHA/SW/lib/utilities/utilities.cpp","JHUtilitiesJH::initJoints",71,95
34,4,495,1,43,"JHUtilitiesJH::extractRegulatorData@102-145@/home/quique/Documentos/RHA/SW/lib/utilities/utilities.cpp","/home/quique/Documentos/RHA/SW/lib/utilities/utilities.cpp","JHUtilitiesJH::extractRegulatorData",102,145
56,13,528,2,62,"JHUtilitiesJH::extractStepSlopeData@148-210@/home/quique/Documentos/RHA/SW/lib/utilities/utilities.cpp","/home/quique/Documentos/RHA/SW/lib/utilities/utilities.cpp","JHUtilitiesJH::extractStepSlopeData",148,210
23,3,172,2,24,"JHUtilitiesJH::checkTimeGetInfo@218-242@/home/quique/Documentos/RHA/SW/lib/utilities/utilities.cpp","/home/quique/Documentos/RHA/SW/lib/utilities/utilities.cpp","JHUtilitiesJH::checkTimeGetInfo",218,242
13,3,75,1,14,"JHUtilitiesJH::checkComSucces@249-263@/home/quique/Documentos/RHA/SW/lib/utilities/utilities.cpp","/home/quique/Documentos/RHA/SW/lib/utilities/utilities.cpp","JHUtilitiesJH::checkComSucces",249,263
55,8,368,1,68,"JHUtilitiesJH::checkSpeed@269-337@/home/quique/Documentos/RHA/SW/lib/utilities/utilities.cpp","/home/quique/Documentos/RHA/SW/lib/utilities/utilities.cpp","JHUtilitiesJH::checkSpeed",269,337
3,1,9,0,2,"JHUtilitiesJH::JHUtilitiesJH@88-90@/home/quique/Documentos/RHA/SW/lib/utilities/utilities.h","/home/quique/Documentos/RHA/SW/lib/utilities/utilities.h","JHUtilitiesJH::JHUtilitiesJH",88,90
21,2,115,0,28,"WiiChuck::begin@78-106@/home/quique/Documentos/RHA/SW/lib/chuck_handler/WiiChuck.h","/home/quique/Documentos/RHA/SW/lib/chuck_handler/WiiChuck.h","WiiChuck::begin",78,106
4,1,13,0,3,"WiiChuck::calibrateJoy@109-112@/home/quique/Documentos/RHA/SW/lib/chuck_handler/WiiChuck.h","/home/quique/Documentos/RHA/SW/lib/chuck_handler/WiiChuck.h","WiiChuck::calibrateJoy",109,112
21,4,189,0,32,"WiiChuck::update@114-146@/home/quique/Documentos/RHA/SW/lib/chuck_handler/WiiChuck.h","/home/quique/Documentos/RHA/SW/lib/chuck_handler/WiiChuck.h","WiiChuck::update",114,146
3,1,16,0,3,"WiiChuck::readAccelX@154-157@/home/quique/Documentos/RHA/SW/lib/chuck_handler/WiiChuck.h","/home/quique/Documentos/RHA/SW/lib/chuck_handler/WiiChuck.h","WiiChuck::readAccelX",154,157
3,1,16,0,3,"WiiChuck::readAccelY@158-161@/home/quique/Documentos/RHA/SW/lib/chuck_handler/WiiChuck.h","/home/quique/Documentos/RHA/SW/lib/chuck_handler/WiiChuck.h","WiiChuck::readAccelY",158,161
3,1,16,0,3,"WiiChuck::readAccelZ@162-165@/home/quique/Documentos/RHA/SW/lib/chuck_handler/WiiChuck.h","/home/quique/Documentos/RHA/SW/lib/chuck_handler/WiiChuck.h","WiiChuck::readAccelZ",162,165
3,2,13,0,2,"WiiChuck::zPressed@167-169@/home/quique/Documentos/RHA/SW/lib/chuck_handler/WiiChuck.h","/home/quique/Documentos/RHA/SW/lib/chuck_handler/WiiChuck.h","WiiChuck::zPressed",167,169
3,2,13,0,2,"WiiChuck::cPressed@170-172@/home/quique/Documentos/RHA/SW/lib/chuck_handler/WiiChuck.h","/home/quique/Documentos/RHA/SW/lib/chuck_handler/WiiChuck.h","WiiChuck::cPressed",170,172
3,1,22,1,2,"WiiChuck::rightJoy@175-177@/home/quique/Documentos/RHA/SW/lib/chuck_handler/WiiChuck.h","/home/quique/Documentos/RHA/SW/lib/chuck_handler/WiiChuck.h","WiiChuck::rightJoy",175,177
3,1,24,1,2,"WiiChuck::leftJoy@180-182@/home/quique/Documentos/RHA/SW/lib/chuck_handler/WiiChuck.h","/home/quique/Documentos/RHA/SW/lib/chuck_handler/WiiChuck.h","WiiChuck::leftJoy",180,182
3,1,13,0,2,"WiiChuck::readJoyX@185-187@/home/quique/Documentos/RHA/SW/lib/chuck_handler/WiiChuck.h","/home/quique/Documentos/RHA/SW/lib/chuck_handler/WiiChuck.h","WiiChuck::readJoyX",185,187
3,1,13,0,2,"WiiChuck::readJoyY@189-191@/home/quique/Documentos/RHA/SW/lib/chuck_handler/WiiChuck.h","/home/quique/Documentos/RHA/SW/lib/chuck_handler/WiiChuck.h","WiiChuck::readJoyY",189,191
3,1,28,0,2,"WiiChuck::readRoll@201-203@/home/quique/Documentos/RHA/SW/lib/chuck_handler/WiiChuck.h","/home/quique/Documentos/RHA/SW/lib/chuck_handler/WiiChuck.h","WiiChuck::readRoll",201,203
3,1,26,0,2,"WiiChuck::readPitch@206-208@/home/quique/Documentos/RHA/SW/lib/chuck_handler/WiiChuck.h","/home/quique/Documentos/RHA/SW/lib/chuck_handler/WiiChuck.h","WiiChuck::readPitch",206,208
4,1,10,1,5,"WiiChuck::_nunchuk_decode_byte@211-216@/home/quique/Documentos/RHA/SW/lib/chuck_handler/WiiChuck.h","/home/quique/Documentos/RHA/SW/lib/chuck_handler/WiiChuck.h","WiiChuck::_nunchuk_decode_byte",211,216
6,1,28,0,5,"WiiChuck::_send_zero@218-223@/home/quique/Documentos/RHA/SW/lib/chuck_handler/WiiChuck.h","/home/quique/Documentos/RHA/SW/lib/chuck_handler/WiiChuck.h","WiiChuck::_send_zero",218,223
1,1,44,4,0,"ChuckReadStruct::ChuckReadStruct@14-14@/home/quique/Documentos/RHA/SW/lib/chuck_handler/chuck_handler.h","/home/quique/Documentos/RHA/SW/lib/chuck_handler/chuck_handler.h","ChuckReadStruct::ChuckReadStruct",14,14
3,1,11,0,2,"ChuckHandler::begin@22-24@/home/quique/Documentos/RHA/SW/lib/chuck_handler/chuck_handler.h","/home/quique/Documentos/RHA/SW/lib/chuck_handler/chuck_handler.h","ChuckHandler::begin",22,24
4,1,20,1,3,"ChuckHandler::setTimer@31-34@/home/quique/Documentos/RHA/SW/lib/chuck_handler/chuck_handler.h","/home/quique/Documentos/RHA/SW/lib/chuck_handler/chuck_handler.h","ChuckHandler::setTimer",31,34
7,1,79,0,6,"ChuckHandler::printChuckValues@36-42@/home/quique/Documentos/RHA/SW/lib/chuck_handler/chuck_handler.h","/home/quique/Documentos/RHA/SW/lib/chuck_handler/chuck_handler.h","ChuckHandler::printChuckValues",36,42
32,13,328,0,45,"ChuckHandler::readAxis@49-94@/home/quique/Documentos/RHA/SW/lib/chuck_handler/chuck_handler.h","/home/quique/Documentos/RHA/SW/lib/chuck_handler/chuck_handler.h","ChuckHandler::readAxis",49,94
17,15,219,2,17,"printServoStatusError@14-31@/home/quique/Documentos/RHA/SW/lib/debug/debug.cpp","/home/quique/Documentos/RHA/SW/lib/debug/debug.cpp","printServoStatusError",14,31
13,1,161,8,12,"printServoStatus@33-45@/home/quique/Documentos/RHA/SW/lib/debug/debug.cpp","/home/quique/Documentos/RHA/SW/lib/debug/debug.cpp","printServoStatus",33,45
