4,1,13,0,9,"process@16-25@/home/quique/Documentos/RHA/SW/test/c_test_fuzzy_regulator/test_fuzzy_regulator.cpp","/home/quique/Documentos/RHA/SW/test/c_test_fuzzy_regulator/test_fuzzy_regulator.cpp","process",16,25
5,1,21,0,4,"setup@28-32@/home/quique/Documentos/RHA/SW/test/c_test_fuzzy_regulator/test_fuzzy_regulator.cpp","/home/quique/Documentos/RHA/SW/test/c_test_fuzzy_regulator/test_fuzzy_regulator.cpp","setup",28,32
6,1,29,0,6,"loop@34-40@/home/quique/Documentos/RHA/SW/test/c_test_fuzzy_regulator/test_fuzzy_regulator.cpp","/home/quique/Documentos/RHA/SW/test/c_test_fuzzy_regulator/test_fuzzy_regulator.cpp","loop",34,40
8,1,50,1,7,"test_class_timer_function_checkwait@25-32@/home/quique/Documentos/RHA/SW/test/a_test_rha_types/test_rha_types.cpp","/home/quique/Documentos/RHA/SW/test/a_test_rha_types/test_rha_types.cpp","test_class_timer_function_checkwait",25,32
8,1,50,1,7,"test_class_timer_function_checkcontinue@34-41@/home/quique/Documentos/RHA/SW/test/a_test_rha_types/test_rha_types.cpp","/home/quique/Documentos/RHA/SW/test/a_test_rha_types/test_rha_types.cpp","test_class_timer_function_checkcontinue",34,41
8,1,50,1,7,"test_class_timer_micros_function_checkwait@43-50@/home/quique/Documentos/RHA/SW/test/a_test_rha_types/test_rha_types.cpp","/home/quique/Documentos/RHA/SW/test/a_test_rha_types/test_rha_types.cpp","test_class_timer_micros_function_checkwait",43,50
8,1,50,1,7,"test_class_timer_micros_function_checkcontinue@52-59@/home/quique/Documentos/RHA/SW/test/a_test_rha_types/test_rha_types.cpp","/home/quique/Documentos/RHA/SW/test/a_test_rha_types/test_rha_types.cpp","test_class_timer_micros_function_checkcontinue",52,59
8,1,33,0,8,"process@62-70@/home/quique/Documentos/RHA/SW/test/a_test_rha_types/test_rha_types.cpp","/home/quique/Documentos/RHA/SW/test/a_test_rha_types/test_rha_types.cpp","process",62,70
5,1,21,0,4,"setup@73-77@/home/quique/Documentos/RHA/SW/test/a_test_rha_types/test_rha_types.cpp","/home/quique/Documentos/RHA/SW/test/a_test_rha_types/test_rha_types.cpp","setup",73,77
6,1,29,0,6,"loop@79-85@/home/quique/Documentos/RHA/SW/test/a_test_rha_types/test_rha_types.cpp","/home/quique/Documentos/RHA/SW/test/a_test_rha_types/test_rha_types.cpp","loop",79,85
11,1,143,1,13,"test_function_warpSinglePacket@23-36@/home/quique/Documentos/RHA/SW/test/f_test_joint_handler_mock/test_joint_handler.cpp","/home/quique/Documentos/RHA/SW/test/f_test_joint_handler_mock/test_joint_handler.cpp","test_function_warpSinglePacket",23,36
23,1,216,1,26,"test_function_addToSyncPacket@44-70@/home/quique/Documentos/RHA/SW/test/f_test_joint_handler_mock/test_joint_handler.cpp","/home/quique/Documentos/RHA/SW/test/f_test_joint_handler_mock/test_joint_handler.cpp","test_function_addToSyncPacket",44,70
34,1,357,1,45,"test_function_warpSyncPacket@72-117@/home/quique/Documentos/RHA/SW/test/f_test_joint_handler_mock/test_joint_handler.cpp","/home/quique/Documentos/RHA/SW/test/f_test_joint_handler_mock/test_joint_handler.cpp","test_function_warpSyncPacket",72,117
12,1,113,1,15,"test_function_checkConection_mock@119-134@/home/quique/Documentos/RHA/SW/test/f_test_joint_handler_mock/test_joint_handler.cpp","/home/quique/Documentos/RHA/SW/test/f_test_joint_handler_mock/test_joint_handler.cpp","test_function_checkConection_mock",119,134
22,1,254,1,32,"test_function_sendSetWheelModeAll_mock@136-168@/home/quique/Documentos/RHA/SW/test/f_test_joint_handler_mock/test_joint_handler.cpp","/home/quique/Documentos/RHA/SW/test/f_test_joint_handler_mock/test_joint_handler.cpp","test_function_sendSetWheelModeAll_mock",136,168
2,1,6,1,39,"test_function_controlLoop_oneJoint@170-209@/home/quique/Documentos/RHA/SW/test/f_test_joint_handler_mock/test_joint_handler.cpp","/home/quique/Documentos/RHA/SW/test/f_test_joint_handler_mock/test_joint_handler.cpp","test_function_controlLoop_oneJoint",170,209
10,1,43,0,12,"process@211-223@/home/quique/Documentos/RHA/SW/test/f_test_joint_handler_mock/test_joint_handler.cpp","/home/quique/Documentos/RHA/SW/test/f_test_joint_handler_mock/test_joint_handler.cpp","process",211,223
5,1,21,0,4,"setup@226-230@/home/quique/Documentos/RHA/SW/test/f_test_joint_handler_mock/test_joint_handler.cpp","/home/quique/Documentos/RHA/SW/test/f_test_joint_handler_mock/test_joint_handler.cpp","setup",226,230
6,1,29,0,6,"loop@232-238@/home/quique/Documentos/RHA/SW/test/f_test_joint_handler_mock/test_joint_handler.cpp","/home/quique/Documentos/RHA/SW/test/f_test_joint_handler_mock/test_joint_handler.cpp","loop",232,238
4,2,42,1,3,"cleanBuffer@24-27@/home/quique/Documentos/RHA/SW/test/d_test_servo_rha/test_servo_rha.cpp","/home/quique/Documentos/RHA/SW/test/d_test_servo_rha/test_servo_rha.cpp","cleanBuffer",24,27
6,1,66,1,5,"test_function_compareAngles@29-34@/home/quique/Documentos/RHA/SW/test/d_test_servo_rha/test_servo_rha.cpp","/home/quique/Documentos/RHA/SW/test/d_test_servo_rha/test_servo_rha.cpp","test_function_compareAngles",29,34
8,1,98,1,7,"test_function_compareSpeed@36-43@/home/quique/Documentos/RHA/SW/test/d_test_servo_rha/test_servo_rha.cpp","/home/quique/Documentos/RHA/SW/test/d_test_servo_rha/test_servo_rha.cpp","test_function_compareSpeed",36,43
8,1,96,1,9,"test_function_addToPacket@46-55@/home/quique/Documentos/RHA/SW/test/d_test_servo_rha/test_servo_rha.cpp","/home/quique/Documentos/RHA/SW/test/d_test_servo_rha/test_servo_rha.cpp","test_function_addToPacket",46,55
7,1,74,1,8,"test_function_updateInfoToPacket@57-65@/home/quique/Documentos/RHA/SW/test/d_test_servo_rha/test_servo_rha.cpp","/home/quique/Documentos/RHA/SW/test/d_test_servo_rha/test_servo_rha.cpp","test_function_updateInfoToPacket",57,65
15,1,142,1,18,"test_function_addReturnOptionToPacket@67-85@/home/quique/Documentos/RHA/SW/test/d_test_servo_rha/test_servo_rha.cpp","/home/quique/Documentos/RHA/SW/test/d_test_servo_rha/test_servo_rha.cpp","test_function_addReturnOptionToPacket",67,85
11,1,110,1,13,"test_function_setTorqueOnOfToPacket@87-100@/home/quique/Documentos/RHA/SW/test/d_test_servo_rha/test_servo_rha.cpp","/home/quique/Documentos/RHA/SW/test/d_test_servo_rha/test_servo_rha.cpp","test_function_setTorqueOnOfToPacket",87,100
17,1,176,1,20,"test_function_set_exit_WheelModeToPacket@102-122@/home/quique/Documentos/RHA/SW/test/d_test_servo_rha/test_servo_rha.cpp","/home/quique/Documentos/RHA/SW/test/d_test_servo_rha/test_servo_rha.cpp","test_function_set_exit_WheelModeToPacket",102,122
11,1,119,1,19,"test_function_updateInfo@124-143@/home/quique/Documentos/RHA/SW/test/d_test_servo_rha/test_servo_rha.cpp","/home/quique/Documentos/RHA/SW/test/d_test_servo_rha/test_servo_rha.cpp","test_function_updateInfo",124,143
27,1,319,1,34,"test_function_calculateTorque@145-179@/home/quique/Documentos/RHA/SW/test/d_test_servo_rha/test_servo_rha.cpp","/home/quique/Documentos/RHA/SW/test/d_test_servo_rha/test_servo_rha.cpp","test_function_calculateTorque",145,179
14,1,205,1,19,"test_function_addTorqueToPacket@181-200@/home/quique/Documentos/RHA/SW/test/d_test_servo_rha/test_servo_rha.cpp","/home/quique/Documentos/RHA/SW/test/d_test_servo_rha/test_servo_rha.cpp","test_function_addTorqueToPacket",181,200
7,1,68,1,9,"test_function_addPingToPacket@202-211@/home/quique/Documentos/RHA/SW/test/d_test_servo_rha/test_servo_rha.cpp","/home/quique/Documentos/RHA/SW/test/d_test_servo_rha/test_servo_rha.cpp","test_function_addPingToPacket",202,211
17,1,169,1,19,"test_function_setSpeedGoal@213-232@/home/quique/Documentos/RHA/SW/test/d_test_servo_rha/test_servo_rha.cpp","/home/quique/Documentos/RHA/SW/test/d_test_servo_rha/test_servo_rha.cpp","test_function_setSpeedGoal",213,232
18,1,173,1,51,"test_function_speedError@234-285@/home/quique/Documentos/RHA/SW/test/d_test_servo_rha/test_servo_rha.cpp","/home/quique/Documentos/RHA/SW/test/d_test_servo_rha/test_servo_rha.cpp","test_function_speedError",234,285
17,1,78,0,19,"process@287-306@/home/quique/Documentos/RHA/SW/test/d_test_servo_rha/test_servo_rha.cpp","/home/quique/Documentos/RHA/SW/test/d_test_servo_rha/test_servo_rha.cpp","process",287,306
5,1,21,0,4,"setup@309-313@/home/quique/Documentos/RHA/SW/test/d_test_servo_rha/test_servo_rha.cpp","/home/quique/Documentos/RHA/SW/test/d_test_servo_rha/test_servo_rha.cpp","setup",309,313
6,1,29,0,6,"loop@315-321@/home/quique/Documentos/RHA/SW/test/d_test_servo_rha/test_servo_rha.cpp","/home/quique/Documentos/RHA/SW/test/d_test_servo_rha/test_servo_rha.cpp","loop",315,321
7,1,55,1,6,"test_class_regulator_function_setRegulator@29-35@/home/quique/Documentos/RHA/SW/test/b_test_pid_regulator/test_pid_regulator.cpp","/home/quique/Documentos/RHA/SW/test/b_test_pid_regulator/test_pid_regulator.cpp","test_class_regulator_function_setRegulator",29,35
11,1,94,1,12,"test_class_regulator_function_resetRegulator@37-49@/home/quique/Documentos/RHA/SW/test/b_test_pid_regulator/test_pid_regulator.cpp","/home/quique/Documentos/RHA/SW/test/b_test_pid_regulator/test_pid_regulator.cpp","test_class_regulator_function_resetRegulator",37,49
7,1,58,1,8,"test_class_regulator_function_regulator_simple@52-60@/home/quique/Documentos/RHA/SW/test/b_test_pid_regulator/test_pid_regulator.cpp","/home/quique/Documentos/RHA/SW/test/b_test_pid_regulator/test_pid_regulator.cpp","test_class_regulator_function_regulator_simple",52,60
8,1,71,1,9,"test_class_regulator_function_regulator_simple_acumulative_1@62-71@/home/quique/Documentos/RHA/SW/test/b_test_pid_regulator/test_pid_regulator.cpp","/home/quique/Documentos/RHA/SW/test/b_test_pid_regulator/test_pid_regulator.cpp","test_class_regulator_function_regulator_simple_acumulative_1",62,71
12,2,91,1,13,"test_class_regulator_function_regulator_simple_acumulative_2@74-87@/home/quique/Documentos/RHA/SW/test/b_test_pid_regulator/test_pid_regulator.cpp","/home/quique/Documentos/RHA/SW/test/b_test_pid_regulator/test_pid_regulator.cpp","test_class_regulator_function_regulator_simple_acumulative_2",74,87
18,4,146,1,25,"test_class_regulator_function_regulator_simple_acumulative_overload@90-115@/home/quique/Documentos/RHA/SW/test/b_test_pid_regulator/test_pid_regulator.cpp","/home/quique/Documentos/RHA/SW/test/b_test_pid_regulator/test_pid_regulator.cpp","test_class_regulator_function_regulator_simple_acumulative_overload",90,115
10,1,43,0,10,"process@119-129@/home/quique/Documentos/RHA/SW/test/b_test_pid_regulator/test_pid_regulator.cpp","/home/quique/Documentos/RHA/SW/test/b_test_pid_regulator/test_pid_regulator.cpp","process",119,129
5,1,21,0,4,"setup@132-136@/home/quique/Documentos/RHA/SW/test/b_test_pid_regulator/test_pid_regulator.cpp","/home/quique/Documentos/RHA/SW/test/b_test_pid_regulator/test_pid_regulator.cpp","setup",132,136
6,1,29,0,6,"loop@138-144@/home/quique/Documentos/RHA/SW/test/b_test_pid_regulator/test_pid_regulator.cpp","/home/quique/Documentos/RHA/SW/test/b_test_pid_regulator/test_pid_regulator.cpp","loop",138,144
27,1,319,1,34,"test_function_calculateTorque@22-56@/home/quique/Documentos/RHA/SW/test/e_test_joint_rha/test_joint_rha.cpp","/home/quique/Documentos/RHA/SW/test/e_test_joint_rha/test_joint_rha.cpp","test_function_calculateTorque",22,56
4,1,13,0,9,"process@58-67@/home/quique/Documentos/RHA/SW/test/e_test_joint_rha/test_joint_rha.cpp","/home/quique/Documentos/RHA/SW/test/e_test_joint_rha/test_joint_rha.cpp","process",58,67
5,1,21,0,4,"setup@70-74@/home/quique/Documentos/RHA/SW/test/e_test_joint_rha/test_joint_rha.cpp","/home/quique/Documentos/RHA/SW/test/e_test_joint_rha/test_joint_rha.cpp","setup",70,74
6,1,29,0,6,"loop@76-82@/home/quique/Documentos/RHA/SW/test/e_test_joint_rha/test_joint_rha.cpp","/home/quique/Documentos/RHA/SW/test/e_test_joint_rha/test_joint_rha.cpp","loop",76,82
