1,1,27,4,0,"TestCytron::TestCytron@16-16@/home/gmv/RHA/SW/test/test_cytron_g15_servo/test_cytron_g15_servo.cpp","/home/gmv/RHA/SW/test/test_cytron_g15_servo/test_cytron_g15_servo.cpp","TestCytron::TestCytron",16,16
1,1,8,0,0,"TestCytron::getServoID@17-17@/home/gmv/RHA/SW/test/test_cytron_g15_servo/test_cytron_g15_servo.cpp","/home/gmv/RHA/SW/test/test_cytron_g15_servo/test_cytron_g15_servo.cpp","TestCytron::getServoID",17,17
1,1,8,0,0,"TestCytron::getTxPin@18-18@/home/gmv/RHA/SW/test/test_cytron_g15_servo/test_cytron_g15_servo.cpp","/home/gmv/RHA/SW/test/test_cytron_g15_servo/test_cytron_g15_servo.cpp","TestCytron::getTxPin",18,18
1,1,8,0,0,"TestCytron::getRxPin@19-19@/home/gmv/RHA/SW/test/test_cytron_g15_servo/test_cytron_g15_servo.cpp","/home/gmv/RHA/SW/test/test_cytron_g15_servo/test_cytron_g15_servo.cpp","TestCytron::getRxPin",19,19
1,1,8,0,0,"TestCytron::getCtrlPin@20-20@/home/gmv/RHA/SW/test/test_cytron_g15_servo/test_cytron_g15_servo.cpp","/home/gmv/RHA/SW/test/test_cytron_g15_servo/test_cytron_g15_servo.cpp","TestCytron::getCtrlPin",20,20
17,13,192,1,16,"checkStatus@23-39@/home/gmv/RHA/SW/test/test_cytron_g15_servo/test_cytron_g15_servo.cpp","/home/gmv/RHA/SW/test/test_cytron_g15_servo/test_cytron_g15_servo.cpp","checkStatus",23,39
10,1,64,1,9,"test_comunication_Cytron_G15_Servo@42-51@/home/gmv/RHA/SW/test/test_cytron_g15_servo/test_cytron_g15_servo.cpp","/home/gmv/RHA/SW/test/test_cytron_g15_servo/test_cytron_g15_servo.cpp","test_comunication_Cytron_G15_Servo",42,51
22,2,197,1,21,"test_positioningMode_functioning@53-74@/home/gmv/RHA/SW/test/test_cytron_g15_servo/test_cytron_g15_servo.cpp","/home/gmv/RHA/SW/test/test_cytron_g15_servo/test_cytron_g15_servo.cpp","test_positioningMode_functioning",53,74
21,2,175,1,31,"test_setWheelMode_functioning@76-107@/home/gmv/RHA/SW/test/test_cytron_g15_servo/test_cytron_g15_servo.cpp","/home/gmv/RHA/SW/test/test_cytron_g15_servo/test_cytron_g15_servo.cpp","test_setWheelMode_functioning",76,107
26,3,204,1,26,"test_function_isMovingPositioningMode@109-135@/home/gmv/RHA/SW/test/test_cytron_g15_servo/test_cytron_g15_servo.cpp","/home/gmv/RHA/SW/test/test_cytron_g15_servo/test_cytron_g15_servo.cpp","test_function_isMovingPositioningMode",109,135
8,1,33,0,7,"process@156-163@/home/gmv/RHA/SW/test/test_cytron_g15_servo/test_cytron_g15_servo.cpp","/home/gmv/RHA/SW/test/test_cytron_g15_servo/test_cytron_g15_servo.cpp","process",156,163
5,1,21,0,4,"setup@166-170@/home/gmv/RHA/SW/test/test_cytron_g15_servo/test_cytron_g15_servo.cpp","/home/gmv/RHA/SW/test/test_cytron_g15_servo/test_cytron_g15_servo.cpp","setup",166,170
6,1,29,0,6,"loop@172-178@/home/gmv/RHA/SW/test/test_cytron_g15_servo/test_cytron_g15_servo.cpp","/home/gmv/RHA/SW/test/test_cytron_g15_servo/test_cytron_g15_servo.cpp","loop",172,178
2,1,27,4,1,"TestServoRHA::TestServoRHA@22-23@/home/gmv/RHA/SW/test/test_servo_real/test_servo_real.cpp","/home/gmv/RHA/SW/test/test_servo_real/test_servo_real.cpp","TestServoRHA::TestServoRHA",22,23
16,1,104,0,20,"TestServoRHA::initServo@26-46@/home/gmv/RHA/SW/test/test_servo_real/test_servo_real.cpp","/home/gmv/RHA/SW/test/test_servo_real/test_servo_real.cpp","TestServoRHA::initServo",26,46
1,1,8,0,0,"TestServoRHA::getServoID@48-48@/home/gmv/RHA/SW/test/test_servo_real/test_servo_real.cpp","/home/gmv/RHA/SW/test/test_servo_real/test_servo_real.cpp","TestServoRHA::getServoID",48,48
1,1,8,0,0,"TestServoRHA::getTxPin@49-49@/home/gmv/RHA/SW/test/test_servo_real/test_servo_real.cpp","/home/gmv/RHA/SW/test/test_servo_real/test_servo_real.cpp","TestServoRHA::getTxPin",49,49
1,1,8,0,0,"TestServoRHA::getRxPin@50-50@/home/gmv/RHA/SW/test/test_servo_real/test_servo_real.cpp","/home/gmv/RHA/SW/test/test_servo_real/test_servo_real.cpp","TestServoRHA::getRxPin",50,50
1,1,8,0,0,"TestServoRHA::getCtrlPin@51-51@/home/gmv/RHA/SW/test/test_servo_real/test_servo_real.cpp","/home/gmv/RHA/SW/test/test_servo_real/test_servo_real.cpp","TestServoRHA::getCtrlPin",51,51
1,1,8,0,0,"TestServoRHA::getMinTorqueCw@53-53@/home/gmv/RHA/SW/test/test_servo_real/test_servo_real.cpp","/home/gmv/RHA/SW/test/test_servo_real/test_servo_real.cpp","TestServoRHA::getMinTorqueCw",53,53
1,1,8,0,0,"TestServoRHA::getMinTorqueCcw@54-54@/home/gmv/RHA/SW/test/test_servo_real/test_servo_real.cpp","/home/gmv/RHA/SW/test/test_servo_real/test_servo_real.cpp","TestServoRHA::getMinTorqueCcw",54,54
1,1,8,0,0,"TestServoRHA::getMaxTorqueCw@55-55@/home/gmv/RHA/SW/test/test_servo_real/test_servo_real.cpp","/home/gmv/RHA/SW/test/test_servo_real/test_servo_real.cpp","TestServoRHA::getMaxTorqueCw",55,55
1,1,8,0,0,"TestServoRHA::getMaxTorqueCcw@56-56@/home/gmv/RHA/SW/test/test_servo_real/test_servo_real.cpp","/home/gmv/RHA/SW/test/test_servo_real/test_servo_real.cpp","TestServoRHA::getMaxTorqueCcw",56,56
1,1,8,0,0,"TestServoRHA::getAccelerationSlope@57-57@/home/gmv/RHA/SW/test/test_servo_real/test_servo_real.cpp","/home/gmv/RHA/SW/test/test_servo_real/test_servo_real.cpp","TestServoRHA::getAccelerationSlope",57,57
1,1,8,0,0,"TestServoRHA::getAccelerationAngle@58-58@/home/gmv/RHA/SW/test/test_servo_real/test_servo_real.cpp","/home/gmv/RHA/SW/test/test_servo_real/test_servo_real.cpp","TestServoRHA::getAccelerationAngle",58,58
1,1,8,0,0,"TestServoRHA::getFlagMoving@59-59@/home/gmv/RHA/SW/test/test_servo_real/test_servo_real.cpp","/home/gmv/RHA/SW/test/test_servo_real/test_servo_real.cpp","TestServoRHA::getFlagMoving",59,59
1,1,8,0,0,"TestServoRHA::getCurrentPose@60-60@/home/gmv/RHA/SW/test/test_servo_real/test_servo_real.cpp","/home/gmv/RHA/SW/test/test_servo_real/test_servo_real.cpp","TestServoRHA::getCurrentPose",60,60
1,1,8,0,0,"TestServoRHA::getGoalPoseEncoder@61-61@/home/gmv/RHA/SW/test/test_servo_real/test_servo_real.cpp","/home/gmv/RHA/SW/test/test_servo_real/test_servo_real.cpp","TestServoRHA::getGoalPoseEncoder",61,61
1,1,8,0,0,"TestServoRHA::getGoalDirection@62-62@/home/gmv/RHA/SW/test/test_servo_real/test_servo_real.cpp","/home/gmv/RHA/SW/test/test_servo_real/test_servo_real.cpp","TestServoRHA::getGoalDirection",62,62
1,1,8,0,0,"TestServoRHA::getInitPose@63-63@/home/gmv/RHA/SW/test/test_servo_real/test_servo_real.cpp","/home/gmv/RHA/SW/test/test_servo_real/test_servo_real.cpp","TestServoRHA::getInitPose",63,63
1,1,8,0,0,"TestServoRHA::getEncoderCurrent@64-64@/home/gmv/RHA/SW/test/test_servo_real/test_servo_real.cpp","/home/gmv/RHA/SW/test/test_servo_real/test_servo_real.cpp","TestServoRHA::getEncoderCurrent",64,64
1,1,8,0,0,"TestServoRHA::getEncoderFlag@65-65@/home/gmv/RHA/SW/test/test_servo_real/test_servo_real.cpp","/home/gmv/RHA/SW/test/test_servo_real/test_servo_real.cpp","TestServoRHA::getEncoderFlag",65,65
1,1,8,0,0,"TestServoRHA::getFlagAccelerating@66-66@/home/gmv/RHA/SW/test/test_servo_real/test_servo_real.cpp","/home/gmv/RHA/SW/test/test_servo_real/test_servo_real.cpp","TestServoRHA::getFlagAccelerating",66,66
1,1,8,0,0,"TestServoRHA::getFlagDecelerating@67-67@/home/gmv/RHA/SW/test/test_servo_real/test_servo_real.cpp","/home/gmv/RHA/SW/test/test_servo_real/test_servo_real.cpp","TestServoRHA::getFlagDecelerating",67,67
1,1,11,1,0,"TestServoRHA::setInitPose@69-69@/home/gmv/RHA/SW/test/test_servo_real/test_servo_real.cpp","/home/gmv/RHA/SW/test/test_servo_real/test_servo_real.cpp","TestServoRHA::setInitPose",69,69
1,1,11,1,0,"TestServoRHA::setCurrentPose@70-70@/home/gmv/RHA/SW/test/test_servo_real/test_servo_real.cpp","/home/gmv/RHA/SW/test/test_servo_real/test_servo_real.cpp","TestServoRHA::setCurrentPose",70,70
1,1,11,1,0,"TestServoRHA::setFlagFirstTimeAccDecel@71-71@/home/gmv/RHA/SW/test/test_servo_real/test_servo_real.cpp","/home/gmv/RHA/SW/test/test_servo_real/test_servo_real.cpp","TestServoRHA::setFlagFirstTimeAccDecel",71,71
1,1,11,1,0,"TestServoRHA::setFlagAccelerating@72-72@/home/gmv/RHA/SW/test/test_servo_real/test_servo_real.cpp","/home/gmv/RHA/SW/test/test_servo_real/test_servo_real.cpp","TestServoRHA::setFlagAccelerating",72,72
1,1,11,1,0,"TestServoRHA::setFlagDecelerating@73-73@/home/gmv/RHA/SW/test/test_servo_real/test_servo_real.cpp","/home/gmv/RHA/SW/test/test_servo_real/test_servo_real.cpp","TestServoRHA::setFlagDecelerating",73,73
11,1,111,1,11,"test_function_setInitServo@77-88@/home/gmv/RHA/SW/test/test_servo_real/test_servo_real.cpp","/home/gmv/RHA/SW/test/test_servo_real/test_servo_real.cpp","test_function_setInitServo",77,88
13,1,87,1,12,"test_function_isMoving@90-102@/home/gmv/RHA/SW/test/test_servo_real/test_servo_real.cpp","/home/gmv/RHA/SW/test/test_servo_real/test_servo_real.cpp","test_function_isMoving",90,102
9,2,79,1,8,"test_function_readAngle@104-112@/home/gmv/RHA/SW/test/test_servo_real/test_servo_real.cpp","/home/gmv/RHA/SW/test/test_servo_real/test_servo_real.cpp","test_function_readAngle",104,112
29,1,230,1,33,"test_function_calibrateTorque@114-147@/home/gmv/RHA/SW/test/test_servo_real/test_servo_real.cpp","/home/gmv/RHA/SW/test/test_servo_real/test_servo_real.cpp","test_function_calibrateTorque",114,147
9,1,38,0,15,"process@149-164@/home/gmv/RHA/SW/test/test_servo_real/test_servo_real.cpp","/home/gmv/RHA/SW/test/test_servo_real/test_servo_real.cpp","process",149,164
5,1,21,0,4,"setup@167-171@/home/gmv/RHA/SW/test/test_servo_real/test_servo_real.cpp","/home/gmv/RHA/SW/test/test_servo_real/test_servo_real.cpp","setup",167,171
6,1,29,0,6,"loop@173-179@/home/gmv/RHA/SW/test/test_servo_real/test_servo_real.cpp","/home/gmv/RHA/SW/test/test_servo_real/test_servo_real.cpp","loop",173,179
6,1,32,4,5,"TestServoRHA::TestServoRHA@22-27@/home/gmv/RHA/SW/test/test_servo_mock/test_servo_mock.cpp","/home/gmv/RHA/SW/test/test_servo_mock/test_servo_mock.cpp","TestServoRHA::TestServoRHA",22,27
12,1,90,0,14,"TestServoRHA::initServo@29-43@/home/gmv/RHA/SW/test/test_servo_mock/test_servo_mock.cpp","/home/gmv/RHA/SW/test/test_servo_mock/test_servo_mock.cpp","TestServoRHA::initServo",29,43
4,1,13,0,3,"TestServoRHA::calibrateTorque@44-47@/home/gmv/RHA/SW/test/test_servo_mock/test_servo_mock.cpp","/home/gmv/RHA/SW/test/test_servo_mock/test_servo_mock.cpp","TestServoRHA::calibrateTorque",44,47
3,1,10,1,2,"TestServoRHA::returnPacketSet@49-51@/home/gmv/RHA/SW/test/test_servo_mock/test_servo_mock.cpp","/home/gmv/RHA/SW/test/test_servo_mock/test_servo_mock.cpp","TestServoRHA::returnPacketSet",49,51
8,3,95,2,7,"TestServoRHA::SetWheelSpeed@53-60@/home/gmv/RHA/SW/test/test_servo_mock/test_servo_mock.cpp","/home/gmv/RHA/SW/test/test_servo_mock/test_servo_mock.cpp","TestServoRHA::SetWheelSpeed",53,60
3,1,9,1,2,"TestServoRHA::begin@62-64@/home/gmv/RHA/SW/test/test_servo_mock/test_servo_mock.cpp","/home/gmv/RHA/SW/test/test_servo_mock/test_servo_mock.cpp","TestServoRHA::begin",62,64
6,1,58,1,5,"test_function_compareAngles@67-72@/home/gmv/RHA/SW/test/test_servo_mock/test_servo_mock.cpp","/home/gmv/RHA/SW/test/test_servo_mock/test_servo_mock.cpp","test_function_compareAngles",67,72
8,1,86,1,7,"test_function_compareSpeed@74-81@/home/gmv/RHA/SW/test/test_servo_mock/test_servo_mock.cpp","/home/gmv/RHA/SW/test/test_servo_mock/test_servo_mock.cpp","test_function_compareSpeed",74,81
17,1,190,1,21,"test_function_addToPacket@89-110@/home/gmv/RHA/SW/test/test_servo_mock/test_servo_mock.cpp","/home/gmv/RHA/SW/test/test_servo_mock/test_servo_mock.cpp","test_function_addToPacket",89,110
33,2,331,1,38,"test_function_warpPacket@112-150@/home/gmv/RHA/SW/test/test_servo_mock/test_servo_mock.cpp","/home/gmv/RHA/SW/test/test_servo_mock/test_servo_mock.cpp","test_function_warpPacket",112,150
11,1,90,1,13,"test_function_SetWheelSpeed@152-165@/home/gmv/RHA/SW/test/test_servo_mock/test_servo_mock.cpp","/home/gmv/RHA/SW/test/test_servo_mock/test_servo_mock.cpp","test_function_SetWheelSpeed",152,165
9,1,38,0,9,"process@167-176@/home/gmv/RHA/SW/test/test_servo_mock/test_servo_mock.cpp","/home/gmv/RHA/SW/test/test_servo_mock/test_servo_mock.cpp","process",167,176
5,1,21,0,4,"setup@179-183@/home/gmv/RHA/SW/test/test_servo_mock/test_servo_mock.cpp","/home/gmv/RHA/SW/test/test_servo_mock/test_servo_mock.cpp","setup",179,183
6,1,29,0,6,"loop@185-191@/home/gmv/RHA/SW/test/test_servo_mock/test_servo_mock.cpp","/home/gmv/RHA/SW/test/test_servo_mock/test_servo_mock.cpp","loop",185,191
