2,1,27,4,1,"TestServoRHA::TestServoRHA@23-24@/home/gmv/RHA/SW/test/test_servo_real/test_servo_real.cpp","/home/gmv/RHA/SW/test/test_servo_real/test_servo_real.cpp","TestServoRHA::TestServoRHA",23,24
1,1,8,0,0,"TestServoRHA::getServoID@26-26@/home/gmv/RHA/SW/test/test_servo_real/test_servo_real.cpp","/home/gmv/RHA/SW/test/test_servo_real/test_servo_real.cpp","TestServoRHA::getServoID",26,26
1,1,8,0,0,"TestServoRHA::getTxPin@27-27@/home/gmv/RHA/SW/test/test_servo_real/test_servo_real.cpp","/home/gmv/RHA/SW/test/test_servo_real/test_servo_real.cpp","TestServoRHA::getTxPin",27,27
1,1,8,0,0,"TestServoRHA::getRxPin@28-28@/home/gmv/RHA/SW/test/test_servo_real/test_servo_real.cpp","/home/gmv/RHA/SW/test/test_servo_real/test_servo_real.cpp","TestServoRHA::getRxPin",28,28
1,1,8,0,0,"TestServoRHA::getCtrlPin@29-29@/home/gmv/RHA/SW/test/test_servo_real/test_servo_real.cpp","/home/gmv/RHA/SW/test/test_servo_real/test_servo_real.cpp","TestServoRHA::getCtrlPin",29,29
1,1,8,0,0,"TestServoRHA::getMinTorqueCw@31-31@/home/gmv/RHA/SW/test/test_servo_real/test_servo_real.cpp","/home/gmv/RHA/SW/test/test_servo_real/test_servo_real.cpp","TestServoRHA::getMinTorqueCw",31,31
1,1,8,0,0,"TestServoRHA::getMinTorqueCCw@32-32@/home/gmv/RHA/SW/test/test_servo_real/test_servo_real.cpp","/home/gmv/RHA/SW/test/test_servo_real/test_servo_real.cpp","TestServoRHA::getMinTorqueCCw",32,32
1,1,8,0,0,"TestServoRHA::getMaxTorqueCw@33-33@/home/gmv/RHA/SW/test/test_servo_real/test_servo_real.cpp","/home/gmv/RHA/SW/test/test_servo_real/test_servo_real.cpp","TestServoRHA::getMaxTorqueCw",33,33
1,1,8,0,0,"TestServoRHA::getMaxTorqueCCw@34-34@/home/gmv/RHA/SW/test/test_servo_real/test_servo_real.cpp","/home/gmv/RHA/SW/test/test_servo_real/test_servo_real.cpp","TestServoRHA::getMaxTorqueCCw",34,34
1,1,8,0,0,"TestServoRHA::getAccelerationSlope@35-35@/home/gmv/RHA/SW/test/test_servo_real/test_servo_real.cpp","/home/gmv/RHA/SW/test/test_servo_real/test_servo_real.cpp","TestServoRHA::getAccelerationSlope",35,35
1,1,8,0,0,"TestServoRHA::getAccelerationAngle@36-36@/home/gmv/RHA/SW/test/test_servo_real/test_servo_real.cpp","/home/gmv/RHA/SW/test/test_servo_real/test_servo_real.cpp","TestServoRHA::getAccelerationAngle",36,36
1,1,8,0,0,"TestServoRHA::getFlagMoving@37-37@/home/gmv/RHA/SW/test/test_servo_real/test_servo_real.cpp","/home/gmv/RHA/SW/test/test_servo_real/test_servo_real.cpp","TestServoRHA::getFlagMoving",37,37
1,1,8,0,0,"TestServoRHA::getCurrentPose@38-38@/home/gmv/RHA/SW/test/test_servo_real/test_servo_real.cpp","/home/gmv/RHA/SW/test/test_servo_real/test_servo_real.cpp","TestServoRHA::getCurrentPose",38,38
1,1,8,0,0,"TestServoRHA::getGoalPoseEncoder@39-39@/home/gmv/RHA/SW/test/test_servo_real/test_servo_real.cpp","/home/gmv/RHA/SW/test/test_servo_real/test_servo_real.cpp","TestServoRHA::getGoalPoseEncoder",39,39
1,1,8,0,0,"TestServoRHA::getGoalDirection@40-40@/home/gmv/RHA/SW/test/test_servo_real/test_servo_real.cpp","/home/gmv/RHA/SW/test/test_servo_real/test_servo_real.cpp","TestServoRHA::getGoalDirection",40,40
1,1,8,0,0,"TestServoRHA::getInitPose@41-41@/home/gmv/RHA/SW/test/test_servo_real/test_servo_real.cpp","/home/gmv/RHA/SW/test/test_servo_real/test_servo_real.cpp","TestServoRHA::getInitPose",41,41
1,1,8,0,0,"TestServoRHA::getEncoderCurrent@42-42@/home/gmv/RHA/SW/test/test_servo_real/test_servo_real.cpp","/home/gmv/RHA/SW/test/test_servo_real/test_servo_real.cpp","TestServoRHA::getEncoderCurrent",42,42
1,1,8,0,0,"TestServoRHA::getEncoderFlag@43-43@/home/gmv/RHA/SW/test/test_servo_real/test_servo_real.cpp","/home/gmv/RHA/SW/test/test_servo_real/test_servo_real.cpp","TestServoRHA::getEncoderFlag",43,43
1,1,11,1,0,"TestServoRHA::setInitPose@45-45@/home/gmv/RHA/SW/test/test_servo_real/test_servo_real.cpp","/home/gmv/RHA/SW/test/test_servo_real/test_servo_real.cpp","TestServoRHA::setInitPose",45,45
1,1,11,1,0,"TestServoRHA::setCurrentPose@46-46@/home/gmv/RHA/SW/test/test_servo_real/test_servo_real.cpp","/home/gmv/RHA/SW/test/test_servo_real/test_servo_real.cpp","TestServoRHA::setCurrentPose",46,46
6,1,49,1,6,"test_function_setGoalEncoder@49-55@/home/gmv/RHA/SW/test/test_servo_real/test_servo_real.cpp","/home/gmv/RHA/SW/test/test_servo_real/test_servo_real.cpp","test_function_setGoalEncoder",49,55
11,1,77,1,10,"test_function_isMoving@57-67@/home/gmv/RHA/SW/test/test_servo_real/test_servo_real.cpp","/home/gmv/RHA/SW/test/test_servo_real/test_servo_real.cpp","test_function_isMoving",57,67
9,2,72,1,8,"test_function_readAngle@69-77@/home/gmv/RHA/SW/test/test_servo_real/test_servo_real.cpp","/home/gmv/RHA/SW/test/test_servo_real/test_servo_real.cpp","test_function_readAngle",69,77
16,1,110,0,16,"configureServoForAccelDecelTest@84-100@/home/gmv/RHA/SW/test/test_servo_real/test_servo_real.cpp","/home/gmv/RHA/SW/test/test_servo_real/test_servo_real.cpp","configureServoForAccelDecelTest",84,100
17,3,133,1,17,"test_function_accelerateCW@102-119@/home/gmv/RHA/SW/test/test_servo_real/test_servo_real.cpp","/home/gmv/RHA/SW/test/test_servo_real/test_servo_real.cpp","test_function_accelerateCW",102,119
18,3,162,1,19,"test_function_decelerateCW@121-140@/home/gmv/RHA/SW/test/test_servo_real/test_servo_real.cpp","/home/gmv/RHA/SW/test/test_servo_real/test_servo_real.cpp","test_function_decelerateCW",121,140
2,1,6,1,2,"test_function_encoderModeRotation@142-144@/home/gmv/RHA/SW/test/test_servo_real/test_servo_real.cpp","/home/gmv/RHA/SW/test/test_servo_real/test_servo_real.cpp","test_function_encoderModeRotation",142,144
10,1,42,0,15,"process@147-162@/home/gmv/RHA/SW/test/test_servo_real/test_servo_real.cpp","/home/gmv/RHA/SW/test/test_servo_real/test_servo_real.cpp","process",147,162
4,1,14,0,3,"setup@165-168@/home/gmv/RHA/SW/test/test_servo_real/test_servo_real.cpp","/home/gmv/RHA/SW/test/test_servo_real/test_servo_real.cpp","setup",165,168
6,1,29,0,6,"loop@170-176@/home/gmv/RHA/SW/test/test_servo_real/test_servo_real.cpp","/home/gmv/RHA/SW/test/test_servo_real/test_servo_real.cpp","loop",170,176
1,1,27,4,0,"TestCytron::TestCytron@16-16@/home/gmv/RHA/SW/test/test_cytrong_g15shield/test_cytron_g15_servo.cpp","/home/gmv/RHA/SW/test/test_cytrong_g15shield/test_cytron_g15_servo.cpp","TestCytron::TestCytron",16,16
1,1,8,0,0,"TestCytron::getServoID@17-17@/home/gmv/RHA/SW/test/test_cytrong_g15shield/test_cytron_g15_servo.cpp","/home/gmv/RHA/SW/test/test_cytrong_g15shield/test_cytron_g15_servo.cpp","TestCytron::getServoID",17,17
1,1,8,0,0,"TestCytron::getTxPin@18-18@/home/gmv/RHA/SW/test/test_cytrong_g15shield/test_cytron_g15_servo.cpp","/home/gmv/RHA/SW/test/test_cytrong_g15shield/test_cytron_g15_servo.cpp","TestCytron::getTxPin",18,18
1,1,8,0,0,"TestCytron::getRxPin@19-19@/home/gmv/RHA/SW/test/test_cytrong_g15shield/test_cytron_g15_servo.cpp","/home/gmv/RHA/SW/test/test_cytrong_g15shield/test_cytron_g15_servo.cpp","TestCytron::getRxPin",19,19
1,1,8,0,0,"TestCytron::getCtrlPin@20-20@/home/gmv/RHA/SW/test/test_cytrong_g15shield/test_cytron_g15_servo.cpp","/home/gmv/RHA/SW/test/test_cytrong_g15shield/test_cytron_g15_servo.cpp","TestCytron::getCtrlPin",20,20
18,13,192,1,17,"checkStatus@24-41@/home/gmv/RHA/SW/test/test_cytrong_g15shield/test_cytron_g15_servo.cpp","/home/gmv/RHA/SW/test/test_cytrong_g15shield/test_cytron_g15_servo.cpp","checkStatus",24,41
7,1,62,1,6,"test_constructor_cytron_g15_servo@43-49@/home/gmv/RHA/SW/test/test_cytrong_g15shield/test_cytron_g15_servo.cpp","/home/gmv/RHA/SW/test/test_cytrong_g15shield/test_cytron_g15_servo.cpp","test_constructor_cytron_g15_servo",43,49
10,1,64,1,9,"test_comunication_cytron_g15_servo@51-60@/home/gmv/RHA/SW/test/test_cytrong_g15shield/test_cytron_g15_servo.cpp","/home/gmv/RHA/SW/test/test_cytrong_g15shield/test_cytron_g15_servo.cpp","test_comunication_cytron_g15_servo",51,60
22,2,197,1,21,"test_positioningMode_functioning@62-83@/home/gmv/RHA/SW/test/test_cytrong_g15shield/test_cytron_g15_servo.cpp","/home/gmv/RHA/SW/test/test_cytrong_g15shield/test_cytron_g15_servo.cpp","test_positioningMode_functioning",62,83
21,2,175,1,31,"test_setWheelMode_functioning@85-116@/home/gmv/RHA/SW/test/test_cytrong_g15shield/test_cytron_g15_servo.cpp","/home/gmv/RHA/SW/test/test_cytrong_g15shield/test_cytron_g15_servo.cpp","test_setWheelMode_functioning",85,116
26,3,204,1,26,"test_function_isMovingPositioningMode@118-144@/home/gmv/RHA/SW/test/test_cytrong_g15shield/test_cytron_g15_servo.cpp","/home/gmv/RHA/SW/test/test_cytrong_g15shield/test_cytron_g15_servo.cpp","test_function_isMovingPositioningMode",118,144
9,1,38,0,8,"process@165-173@/home/gmv/RHA/SW/test/test_cytrong_g15shield/test_cytron_g15_servo.cpp","/home/gmv/RHA/SW/test/test_cytrong_g15shield/test_cytron_g15_servo.cpp","process",165,173
5,1,21,0,4,"setup@176-180@/home/gmv/RHA/SW/test/test_cytrong_g15shield/test_cytron_g15_servo.cpp","/home/gmv/RHA/SW/test/test_cytrong_g15shield/test_cytron_g15_servo.cpp","setup",176,180
6,1,29,0,6,"loop@182-188@/home/gmv/RHA/SW/test/test_cytrong_g15shield/test_cytron_g15_servo.cpp","/home/gmv/RHA/SW/test/test_cytrong_g15shield/test_cytron_g15_servo.cpp","loop",182,188
6,1,32,4,5,"TestServoRHA::TestServoRHA@25-30@/home/gmv/RHA/SW/test/test_servo_mock/test_servo_mock.cpp","/home/gmv/RHA/SW/test/test_servo_mock/test_servo_mock.cpp","TestServoRHA::TestServoRHA",25,30
12,1,81,0,15,"TestServoRHA::initServo@32-47@/home/gmv/RHA/SW/test/test_servo_mock/test_servo_mock.cpp","/home/gmv/RHA/SW/test/test_servo_mock/test_servo_mock.cpp","TestServoRHA::initServo",32,47
4,1,13,0,3,"TestServoRHA::calibrateTorque@48-51@/home/gmv/RHA/SW/test/test_servo_mock/test_servo_mock.cpp","/home/gmv/RHA/SW/test/test_servo_mock/test_servo_mock.cpp","TestServoRHA::calibrateTorque",48,51
3,1,10,1,2,"TestServoRHA::returnPacketSet@53-55@/home/gmv/RHA/SW/test/test_servo_mock/test_servo_mock.cpp","/home/gmv/RHA/SW/test/test_servo_mock/test_servo_mock.cpp","TestServoRHA::returnPacketSet",53,55
8,3,95,2,7,"TestServoRHA::SetWheelSpeed@57-64@/home/gmv/RHA/SW/test/test_servo_mock/test_servo_mock.cpp","/home/gmv/RHA/SW/test/test_servo_mock/test_servo_mock.cpp","TestServoRHA::SetWheelSpeed",57,64
3,1,9,1,2,"TestServoRHA::begin@66-68@/home/gmv/RHA/SW/test/test_servo_mock/test_servo_mock.cpp","/home/gmv/RHA/SW/test/test_servo_mock/test_servo_mock.cpp","TestServoRHA::begin",66,68
6,1,58,1,5,"test_function_compareAngles@71-76@/home/gmv/RHA/SW/test/test_servo_mock/test_servo_mock.cpp","/home/gmv/RHA/SW/test/test_servo_mock/test_servo_mock.cpp","test_function_compareAngles",71,76
8,1,86,1,7,"test_function_compareSpeed@78-85@/home/gmv/RHA/SW/test/test_servo_mock/test_servo_mock.cpp","/home/gmv/RHA/SW/test/test_servo_mock/test_servo_mock.cpp","test_function_compareSpeed",78,85
17,1,190,1,22,"test_function_addToPacket@93-115@/home/gmv/RHA/SW/test/test_servo_mock/test_servo_mock.cpp","/home/gmv/RHA/SW/test/test_servo_mock/test_servo_mock.cpp","test_function_addToPacket",93,115
33,2,331,1,38,"test_function_warpPacket@117-155@/home/gmv/RHA/SW/test/test_servo_mock/test_servo_mock.cpp","/home/gmv/RHA/SW/test/test_servo_mock/test_servo_mock.cpp","test_function_warpPacket",117,155
10,1,78,1,10,"test_function_SetWheelSpeed@157-167@/home/gmv/RHA/SW/test/test_servo_mock/test_servo_mock.cpp","/home/gmv/RHA/SW/test/test_servo_mock/test_servo_mock.cpp","test_function_SetWheelSpeed",157,167
9,1,38,0,9,"process@169-178@/home/gmv/RHA/SW/test/test_servo_mock/test_servo_mock.cpp","/home/gmv/RHA/SW/test/test_servo_mock/test_servo_mock.cpp","process",169,178
4,1,14,0,3,"setup@181-184@/home/gmv/RHA/SW/test/test_servo_mock/test_servo_mock.cpp","/home/gmv/RHA/SW/test/test_servo_mock/test_servo_mock.cpp","setup",181,184
6,1,29,0,6,"loop@186-192@/home/gmv/RHA/SW/test/test_servo_mock/test_servo_mock.cpp","/home/gmv/RHA/SW/test/test_servo_mock/test_servo_mock.cpp","loop",186,192
