3,1,20,4,2,"TestServoRHA::TestServoRHA@33-35@/home/quique/Documentos/RHA/SW/test/test_servo_mock/test_servo_mock.cpp","/home/quique/Documentos/RHA/SW/test/test_servo_mock/test_servo_mock.cpp","TestServoRHA::TestServoRHA",33,35
8,1,38,0,9,"TestServoRHA::initServo@37-46@/home/quique/Documentos/RHA/SW/test/test_servo_mock/test_servo_mock.cpp","/home/quique/Documentos/RHA/SW/test/test_servo_mock/test_servo_mock.cpp","TestServoRHA::initServo",37,46
4,1,13,0,3,"TestServoRHA::calibrateTorque@47-50@/home/quique/Documentos/RHA/SW/test/test_servo_mock/test_servo_mock.cpp","/home/quique/Documentos/RHA/SW/test/test_servo_mock/test_servo_mock.cpp","TestServoRHA::calibrateTorque",47,50
3,1,10,1,2,"TestServoRHA::returnPacketSet@52-54@/home/quique/Documentos/RHA/SW/test/test_servo_mock/test_servo_mock.cpp","/home/quique/Documentos/RHA/SW/test/test_servo_mock/test_servo_mock.cpp","TestServoRHA::returnPacketSet",52,54
8,3,95,2,7,"TestServoRHA::SetWheelSpeed@56-63@/home/quique/Documentos/RHA/SW/test/test_servo_mock/test_servo_mock.cpp","/home/quique/Documentos/RHA/SW/test/test_servo_mock/test_servo_mock.cpp","TestServoRHA::SetWheelSpeed",56,63
3,1,9,1,2,"TestServoRHA::begin@65-67@/home/quique/Documentos/RHA/SW/test/test_servo_mock/test_servo_mock.cpp","/home/quique/Documentos/RHA/SW/test/test_servo_mock/test_servo_mock.cpp","TestServoRHA::begin",65,67
6,1,58,1,5,"test_function_compareAngles@70-75@/home/quique/Documentos/RHA/SW/test/test_servo_mock/test_servo_mock.cpp","/home/quique/Documentos/RHA/SW/test/test_servo_mock/test_servo_mock.cpp","test_function_compareAngles",70,75
8,1,86,1,7,"test_function_compareSpeed@77-84@/home/quique/Documentos/RHA/SW/test/test_servo_mock/test_servo_mock.cpp","/home/quique/Documentos/RHA/SW/test/test_servo_mock/test_servo_mock.cpp","test_function_compareSpeed",77,84
17,1,190,1,21,"test_function_addToPacket@92-113@/home/quique/Documentos/RHA/SW/test/test_servo_mock/test_servo_mock.cpp","/home/quique/Documentos/RHA/SW/test/test_servo_mock/test_servo_mock.cpp","test_function_addToPacket",92,113
33,2,331,1,38,"test_function_warpPacket@115-153@/home/quique/Documentos/RHA/SW/test/test_servo_mock/test_servo_mock.cpp","/home/quique/Documentos/RHA/SW/test/test_servo_mock/test_servo_mock.cpp","test_function_warpPacket",115,153
11,1,91,1,13,"test_function_SetWheelSpeed@155-168@/home/quique/Documentos/RHA/SW/test/test_servo_mock/test_servo_mock.cpp","/home/quique/Documentos/RHA/SW/test/test_servo_mock/test_servo_mock.cpp","test_function_SetWheelSpeed",155,168
8,1,33,0,9,"process@170-179@/home/quique/Documentos/RHA/SW/test/test_servo_mock/test_servo_mock.cpp","/home/quique/Documentos/RHA/SW/test/test_servo_mock/test_servo_mock.cpp","process",170,179
5,1,21,0,4,"setup@182-186@/home/quique/Documentos/RHA/SW/test/test_servo_mock/test_servo_mock.cpp","/home/quique/Documentos/RHA/SW/test/test_servo_mock/test_servo_mock.cpp","setup",182,186
6,1,29,0,6,"loop@188-194@/home/quique/Documentos/RHA/SW/test/test_servo_mock/test_servo_mock.cpp","/home/quique/Documentos/RHA/SW/test/test_servo_mock/test_servo_mock.cpp","loop",188,194
2,1,27,4,1,"TestServoRHA::TestServoRHA@32-33@/home/quique/Documentos/RHA/SW/test/test_servo_real/test_servo_real.cpp","/home/quique/Documentos/RHA/SW/test/test_servo_real/test_servo_real.cpp","TestServoRHA::TestServoRHA",32,33
1,1,5,0,0,"TestServoRHA::TestServoRHA@34-34@/home/quique/Documentos/RHA/SW/test/test_servo_real/test_servo_real.cpp","/home/quique/Documentos/RHA/SW/test/test_servo_real/test_servo_real.cpp","TestServoRHA::TestServoRHA",34,34
7,1,32,0,10,"TestServoRHA::initServo@37-47@/home/quique/Documentos/RHA/SW/test/test_servo_real/test_servo_real.cpp","/home/quique/Documentos/RHA/SW/test/test_servo_real/test_servo_real.cpp","TestServoRHA::initServo",37,47
1,1,8,0,0,"TestServoRHA::getServoID@49-49@/home/quique/Documentos/RHA/SW/test/test_servo_real/test_servo_real.cpp","/home/quique/Documentos/RHA/SW/test/test_servo_real/test_servo_real.cpp","TestServoRHA::getServoID",49,49
1,1,8,0,0,"TestServoRHA::getMinTorqueCw@51-51@/home/quique/Documentos/RHA/SW/test/test_servo_real/test_servo_real.cpp","/home/quique/Documentos/RHA/SW/test/test_servo_real/test_servo_real.cpp","TestServoRHA::getMinTorqueCw",51,51
1,1,8,0,0,"TestServoRHA::getMinTorqueCcw@52-52@/home/quique/Documentos/RHA/SW/test/test_servo_real/test_servo_real.cpp","/home/quique/Documentos/RHA/SW/test/test_servo_real/test_servo_real.cpp","TestServoRHA::getMinTorqueCcw",52,52
1,1,8,0,0,"TestServoRHA::getMaxTorqueCw@53-53@/home/quique/Documentos/RHA/SW/test/test_servo_real/test_servo_real.cpp","/home/quique/Documentos/RHA/SW/test/test_servo_real/test_servo_real.cpp","TestServoRHA::getMaxTorqueCw",53,53
1,1,8,0,0,"TestServoRHA::getMaxTorqueCcw@54-54@/home/quique/Documentos/RHA/SW/test/test_servo_real/test_servo_real.cpp","/home/quique/Documentos/RHA/SW/test/test_servo_real/test_servo_real.cpp","TestServoRHA::getMaxTorqueCcw",54,54
8,1,56,1,8,"test_function_setInitServo@58-66@/home/quique/Documentos/RHA/SW/test/test_servo_real/test_servo_real.cpp","/home/quique/Documentos/RHA/SW/test/test_servo_real/test_servo_real.cpp","test_function_setInitServo",58,66
13,1,89,1,12,"test_function_isMoving@68-80@/home/quique/Documentos/RHA/SW/test/test_servo_real/test_servo_real.cpp","/home/quique/Documentos/RHA/SW/test/test_servo_real/test_servo_real.cpp","test_function_isMoving",68,80
9,2,79,1,8,"test_function_readAngle@82-90@/home/quique/Documentos/RHA/SW/test/test_servo_real/test_servo_real.cpp","/home/quique/Documentos/RHA/SW/test/test_servo_real/test_servo_real.cpp","test_function_readAngle",82,90
29,1,230,1,33,"test_function_calibrateTorque@92-125@/home/quique/Documentos/RHA/SW/test/test_servo_real/test_servo_real.cpp","/home/quique/Documentos/RHA/SW/test/test_servo_real/test_servo_real.cpp","test_function_calibrateTorque",92,125
8,1,33,0,14,"process@127-141@/home/quique/Documentos/RHA/SW/test/test_servo_real/test_servo_real.cpp","/home/quique/Documentos/RHA/SW/test/test_servo_real/test_servo_real.cpp","process",127,141
5,1,21,0,4,"setup@144-148@/home/quique/Documentos/RHA/SW/test/test_servo_real/test_servo_real.cpp","/home/quique/Documentos/RHA/SW/test/test_servo_real/test_servo_real.cpp","setup",144,148
6,1,29,0,6,"loop@150-156@/home/quique/Documentos/RHA/SW/test/test_servo_real/test_servo_real.cpp","/home/quique/Documentos/RHA/SW/test/test_servo_real/test_servo_real.cpp","loop",150,156
1,1,27,4,0,"TestCytron::TestCytron@27-27@/home/quique/Documentos/RHA/SW/test/test_cytron_g15_servo/test_cytron_g15_servo.cpp","/home/quique/Documentos/RHA/SW/test/test_cytron_g15_servo/test_cytron_g15_servo.cpp","TestCytron::TestCytron",27,27
1,1,8,0,0,"TestCytron::getServoID@28-28@/home/quique/Documentos/RHA/SW/test/test_cytron_g15_servo/test_cytron_g15_servo.cpp","/home/quique/Documentos/RHA/SW/test/test_cytron_g15_servo/test_cytron_g15_servo.cpp","TestCytron::getServoID",28,28
17,13,192,1,16,"testStatus@31-47@/home/quique/Documentos/RHA/SW/test/test_cytron_g15_servo/test_cytron_g15_servo.cpp","/home/quique/Documentos/RHA/SW/test/test_cytron_g15_servo/test_cytron_g15_servo.cpp","testStatus",31,47
10,1,64,1,9,"test_comunication_Cytron_G15_Servo@50-59@/home/quique/Documentos/RHA/SW/test/test_cytron_g15_servo/test_cytron_g15_servo.cpp","/home/quique/Documentos/RHA/SW/test/test_cytron_g15_servo/test_cytron_g15_servo.cpp","test_comunication_Cytron_G15_Servo",50,59
22,2,197,1,21,"test_positioningMode_functioning@61-82@/home/quique/Documentos/RHA/SW/test/test_cytron_g15_servo/test_cytron_g15_servo.cpp","/home/quique/Documentos/RHA/SW/test/test_cytron_g15_servo/test_cytron_g15_servo.cpp","test_positioningMode_functioning",61,82
21,2,175,1,31,"test_setWheelMode_functioning@84-115@/home/quique/Documentos/RHA/SW/test/test_cytron_g15_servo/test_cytron_g15_servo.cpp","/home/quique/Documentos/RHA/SW/test/test_cytron_g15_servo/test_cytron_g15_servo.cpp","test_setWheelMode_functioning",84,115
26,3,204,1,26,"test_function_isMovingPositioningMode@117-143@/home/quique/Documentos/RHA/SW/test/test_cytron_g15_servo/test_cytron_g15_servo.cpp","/home/quique/Documentos/RHA/SW/test/test_cytron_g15_servo/test_cytron_g15_servo.cpp","test_function_isMovingPositioningMode",117,143
8,1,33,0,7,"process@164-171@/home/quique/Documentos/RHA/SW/test/test_cytron_g15_servo/test_cytron_g15_servo.cpp","/home/quique/Documentos/RHA/SW/test/test_cytron_g15_servo/test_cytron_g15_servo.cpp","process",164,171
5,1,21,0,4,"setup@174-178@/home/quique/Documentos/RHA/SW/test/test_cytron_g15_servo/test_cytron_g15_servo.cpp","/home/quique/Documentos/RHA/SW/test/test_cytron_g15_servo/test_cytron_g15_servo.cpp","setup",174,178
6,1,29,0,6,"loop@180-186@/home/quique/Documentos/RHA/SW/test/test_cytron_g15_servo/test_cytron_g15_servo.cpp","/home/quique/Documentos/RHA/SW/test/test_cytron_g15_servo/test_cytron_g15_servo.cpp","loop",180,186
